TAG	TEXT	COMMENT
ChromaggusBoss_Death_1	Groaaarr!	
ChromaggusBoss_EmoteResponse_1	*Knurr*	
ChromaggusBoss_Start_1	Groar!	
LOE_07_MINE_CART_EMOTES	KLONK	
OnyxiaBoss_Death_1	Groaaaarr!	
OnyxiaBoss_EmoteResponse_1	*Knurr*	
OnyxiaBoss_Start_1	Groar!	
POPUP_FROST_BRAWL	Erschöpfung! Wer am Ende des nächsten Zugs mehr Leben hat, gewinnt das Spiel.	
POPUP_FROST_BRAWL_ARMOR	In diesem Kartenchaos könnt Ihr Euch nicht mehr hinter Rüstung verstecken!	
VO_Ahune_Male_Elemental_Brawl_01	JA! ZERSCHMETTERT RAGNAROS!	
VO_Ahune_Male_Elemental_Brawl_02	WER HAT JETZT DIE OBERHAND, ARMLEUCHTER?	
VO_Ahune_Male_Elemental_Brawl_03	DIES IST MEINE RACHE!	
VO_Ahune_Male_Elemental_Brawl_04	NA, WER IST JETZT DER MEISTGETÖTETE BOSS, HMM, RAGNAROS?	
VO_Ahune_Male_Elemental_Brawl_05	WER IST JETZT DAS INSEKT, HMM?!	
VO_Ahune_Male_Elemental_Brawl_07	DER EISBROCKEN IST GESCHMOLZEN!	
VO_Ahune_Male_Elemental_Brawl_08	WER ZERSCHMETTERT MEHR DUMMKÖPFE!?	
VO_Ahune_Male_Elemental_Brawl_11	EIN AUSGEZEICHNETES ERGEBNIS!	
VO_Ahune_Male_Elemental_Brawl_15	IHR MÜSST RAGNAROS VERNICHTENDER SCHLAGEN!	
VO_Ahune_Male_Elemental_Brawl_16	EUER HASS AUF RAGNAROS IST VORBILDLICH!	
VO_Aran_Male_Shade_AranCrackle_01	Hmpf. Als ich jung war, verursachte Knistern jedes Mal sechs Schaden.	
VO_Aran_Male_Shade_AranDeath_02	Nicht schon wieder_...	
VO_Aran_Male_Shade_AranEmoteResponse_01	Hinfort mit Euch!	
VO_Aran_Male_Shade_AranHeroPower_01	Brennt, Ihr Ruhestörer!	
VO_Aran_Male_Shade_AranMedivhSkin_01	Medivh? Nein, nein_... Ich unterhalte mich nur mit unseren Gästen_...	
VO_Aran_Male_Shade_AranOpen_01	Ich werde Euch Manieren beibringen!	
VO_Aran_Male_Shade_AranSpell_03	Zurück in die eisige Finsternis mit Euch!	
VO_Aran_Male_Shade_AranSpell_04	Der Meister ist sehr mächtig_... aber ich habe meine eigenen Kräfte!	
VO_Aran_Male_Shade_AranTrons_02	Hört auf mit diesem fürchterlichen Radau! Dieses 'Hallo' treibt mich in den Wahnsinn!	
VO_Aran_Male_Shade_AranTurn1_01	Keine laute Musik in meinem Turm!	
VO_Aran_Male_Shade_AranTurn5_01	Ich bin kein einfacher Hofnarr! Ich bin Nielas Aran!	
VO_Barnes_Male_Human_FinalNazraTurn5_02	Hilfe! Uns sind die Bananen ausgegangen! Mukla stellt die gesamte Speisekammer auf den Kopf!	
VO_Barnes_Male_Human_JulianneTurn5_01	Was wäre ein Fest ohne ein Schauspiel? Und was wäre ein Schauspiel ohne ein Publikum?	
VO_Barnes_Male_Human_JulianneWin_01	Der erste Akt ist zu Ende! Freut Euch auf zwei weitere!	
VO_Barnes_Male_Human_Wing2Intro_02	Willkommen im Theater! Ich bin Barnes, der Intendant. Die Portale, die Euch zu Medivh führen, sind im Obergeschoss, doch zunächst: Nehmt Platz und genießt die Aufführung!	
VO_Barnes_Male_Human_WolfBigMinion_01	Oh Großmutter, was hast du für gewaltige Diener!	
VO_Barnes_Male_Human_WolfClaws_01	Keine Panik, diese riesigen Klauen sind nur_... äh_... Requisiten!	
VO_Barnes_Male_Human_WolfTurn5_01	Ich liebe es, das Publikum miteinzubeziehen! Lauft, kleiner Gast, lauft!	
VO_Barnes_Male_Human_WolfTurn9_01	Haha! Was für ein Schauspiel! Sogar besser als der Oger, den wir letzte Woche auf der Bühne rumgescheucht haben!	
VO_Barnes_Male_Human_WolfWin_01	Aha! Und nun zum großen Finale!	
VO_BigBadWolf_Male_Worgen_WolfBigMinion_01	Damit ich dich besser zermalmen kann!	
VO_BigBadWolf_Male_Worgen_WolfDeath_01	Ich_... gejagt? Nein...	
VO_BigBadWolf_Male_Worgen_WolfDireWolfAlpha_01	*Knurren*	
VO_BigBadWolf_Male_Worgen_WolfDireWolfAlpha_02	*Wimmern*	
VO_BigBadWolf_Male_Worgen_WolfEmoteResponse_01	Mmmm... lecker.	
VO_BigBadWolf_Male_Worgen_WolfOpen_01	Lauf, kleines Mädchen! Lauf!	
VO_BigBadWolf_Male_Worgen_WolfScarletCrusader_01	Oh, Rotkäppchen, wohin des Weges?	
VO_BigBadWolf_Male_Worgen_WolfTurn1_01	Schau auf deine Diener. Sieh, wie sie vor mir zurückweichen!	
VO_BlackKing_Male_ChessPiece_ChessEmoteGreetings_01	Jederzeit.	
VO_BlackKing_Male_ChessPiece_ChessEmoteOops_01	Oder eine Falle?	
VO_BlackKing_Male_ChessPiece_ChessEmoteSorry_01	Ein notwendiges Opfer.	
VO_BlackKing_Male_ChessPiece_ChessEmoteThanks	Jederzeit.	
VO_BlackKing_Male_ChessPiece_ChessEmoteThanks_01	Jederzeit.	
VO_BlackKing_Male_ChessPiece_ChessEmoteThreaten_01	Ich sehe eines in 3.	
VO_BlackKing_Male_ChessPiece_ChessEmoteWellPlayed_01	Noch nicht.	
VO_BlackKing_Male_ChessPiece_ChessEmoteWow_01	Selbstverständlich.	
VO_BlackKing_Male_ChessPiece_ChessOpen_01	Ihr könnt nicht vorbei!	
VO_BOSS_AYA_Female_Pandaren_BC_0_Jade_Golem_02	Mehr Golems? Super!	
VO_BOSS_AYA_Female_Pandaren_BC_0_Jade_Golem_03	Hihihi! Auf geht's, meine Armee!	
VO_BOSS_AYA_Female_Pandaren_BC_0_Jade_Golem_04	Noch einen! NOCH EINEN!	
VO_BOSS_AYA_Female_Pandaren_BC_2_1st_Turn_Start_01	Nix da! Ich will Gadgetzan für mich allein!	
VO_BOSS_AYA_Female_Pandaren_BC_2_2nd_Turn_Start_01	Gadgetzan gehört dem Jadelotus, und der Jadelotus gehört mir!	
VO_BOSS_AYA_Female_Pandaren_BC_2_Arms_Dealing1_01	Mehr Waffen. Wie originell.	
VO_BOSS_AYA_Female_Pandaren_BC_2_Fill1_01	Uuuh, das hier wird dir gefallen!	
VO_BOSS_AYA_Female_Pandaren_BC_2_Fill2_01	Mmm... nö! Mir gefällt's hier. Ich glaub, ich bleibe noch!	
VO_BOSS_AYA_Female_Pandaren_BC_2_Goons_Win_01	Nein nein nein! Nicht gut, überhaupt nicht gut!	
VO_BOSS_AYA_Female_Pandaren_BC_2_Goons_Winning_02	Vielleicht solltest du einfach DIE KLAPPE HALTEN UND STERBEN!	
VO_BOSS_AYA_Female_Pandaren_BC_2_Jade_Win_01	Und wieder einmal gewinnt der Jadelotus! Ich bin einfach zu gut!	
VO_BOSS_AYA_Female_Pandaren_BC_2_Lotus_Winning_01	Hihi, spiel ruhig weiter, ich hab grad richtig Spaß!	
VO_BOSS_AYA_Female_Pandaren_BC_3_1st_Turn_Start_01	Gadgetzan ist einfach DER WAHNSINN! Ich will es haben!	
VO_BOSS_AYA_Female_Pandaren_BC_3_1st_Turn_Start_02	Hihihi, mit Vergnügen.	
VO_BOSS_AYA_Female_Pandaren_BC_3_2nd_Turn_Start_01	Oh Mann, ihr Kabale-Typen seid so langweilig!	
VO_BOSS_AYA_Female_Pandaren_BC_3_Fill1_01	Schöner Tag heute, was, Kazzy?	
VO_BOSS_AYA_Female_Pandaren_BC_3_Fill2_01	Oh Mann, Kazzy, mach dich locker, hab mal ein bisschen Spaß.	
VO_BOSS_AYA_Female_Pandaren_BC_3_Jade_Golem3_01	Hihihi!	
VO_BOSS_AYA_Female_Pandaren_BC_3_Kabal_Winning_01	Aber nur, weil du so ein Langweiler bist.	
VO_BOSS_AYA_Female_Pandaren_BC_3_Kabal_Wins_01	Das ist unmöglich! NEIN NEIN NEIN NEIN!	
VO_BOSS_AYA_Female_Pandaren_BC_3_Lotus_Winning_01	Oooh, was ist los, Kazzy? Du siehst irgendwie niedergeschlagen aus.	
VO_BOSS_AYA_Female_Pandaren_BC_3_Lotus_Wins_01	Hach, das hat echt Spaß gemacht. Gegen dich spiel ich am liebsten, Kazzy.	
VO_BOSS_AYA_Female_Pandaren_BC_3_Potion1_02	Bla bla bla Tränke, bla bla bla bla_... Komm schon her, damit ich dich endlich töten kann!	
VO_BOSS_AYA_Female_Pandaren_BC_3_Potion3_01	Igitt! Das Zeug ist ja mal so was von eklig.	
VO_BOSS_AYA_Female_Pandaren_Concede_01	Ach menno, mit dir macht es überhaupt keinen Spaß.	
VO_BOSS_AYA_Female_Pandaren_Greetings_01	Hallöchen!	
VO_BOSS_AYA_Female_Pandaren_Oops_01	Ups!	
VO_BOSS_AYA_Female_Pandaren_START_01	Macht die Golems bereit!	
VO_BOSS_AYA_Female_Pandaren_Thanks_02	Oh, wie lieb von dir, danke!	
VO_BOSS_AYA_Female_Pandaren_Threaten_02	Hmm, das war's wohl für dich.	
VO_BOSS_AYA_Female_Pandaren_Well_Played_01	Das war ja mal so was von cool!	
VO_BOSS_AYA_Female_Pandaren_Wow_02	Wow, abgefahren!	
VO_BOSS_CHO_Male_Ogre_BC_1_1st_Turn_Start_01	GEFÄHRLICH, WEIL GASSENHAUER HIER!	
VO_BOSS_CHO_Male_Ogre_BC_1_Fill2_01	SCHNAPPT IHN EUCH!	
VO_BOSS_CHO_Male_Ogre_BC_2_Fill1_01	MÄDCHEN HAT IRREN BLICK!	
VO_BOSS_CHO_Male_Ogre_Concede_01	GENAU! WARTE_... NEIN, DEINE!	
VO_BOSS_CHO_Male_Ogre_Oops_02	FALSCHER FEHLER!	
VO_BOSS_CHO_Male_Ogre_Thanks_01	DANKE.	
VO_BOSS_HAN_Male_Ogre_BC_0_Arms_Dealing_01	Da ist gerade was vom_... äh, Laster gefallen, hehehe_...	
VO_BOSS_HAN_Male_Ogre_BC_0_Arms_Dealing_02	Gang, macht Euch bereit!	
VO_BOSS_HAN_Male_Ogre_BC_0_Arms_Dealing_03	Lassen wir die Waffen sprechen!	
VO_BOSS_HAN_Male_Ogre_BC_0_Arms_Dealing_04	Ladet Eure Knarren, Jungs!	
VO_BOSS_HAN_Male_Ogre_BC_1_1st_Turn_Start_01	Diese Straßen sind gefährlich, Kazakus.	
VO_BOSS_HAN_Male_Ogre_BC_1_2nd_Turn_Start_01	Gadgetzan gehört den Gassenhauern.	
VO_BOSS_HAN_Male_Ogre_BC_1_2nd_Turn_Start_02	Das ist ja alles wunderbar, aber Gadgetzan gehört den Gassenhauern.	
VO_BOSS_HAN_Male_Ogre_BC_1_Fill1_01	Eure Tränke könnt Ihr Euch sonst wohin stecken!	
VO_BOSS_HAN_Male_Ogre_BC_1_Fill2_01	Cho, sag den Jungs Bescheid. Dieser Troll braucht 'ne kleine Lektion.	test
VO_BOSS_HAN_Male_Ogre_BC_1_Goons_Win_01	Tut mir leid, Kazakus. Das ist rein geschäftlich.	
VO_BOSS_HAN_Male_Ogre_BC_1_Goons_Winning_01	Och, Ihr seht aus, als hättet Ihr einen kleinen Unfall gehabt, Kazakus!	
VO_BOSS_HAN_Male_Ogre_BC_1_Kabal_Win_02	Das ist_... noch nicht_... vorbei_... Kazakus_...	
VO_BOSS_HAN_Male_Ogre_BC_1_Kabal_Winning_02	Ha. Nicht schlecht, alter Mann.	
VO_BOSS_HAN_Male_Ogre_BC_1_Potion1_01	Ich hab Tränke noch nie gemocht.	
VO_BOSS_HAN_Male_Ogre_BC_1_Potion2_01	Oh! Passt auf, wo Ihr das hinwerft!	
VO_BOSS_HAN_Male_Ogre_BC_2_1st_Turn_Start_01	Gadgetzan ist fest in unserer Hand. Also schwirrt ab, Kleine!	
VO_BOSS_HAN_Male_Ogre_BC_2_1st_Turn_Start_04	Tja, also_... die Gassenhauer-Gang hätte da ein Wörtchen mitzureden.	
VO_BOSS_HAN_Male_Ogre_BC_2_Fill1_01	Ich mag diesen Blick nicht, Aya.	
VO_BOSS_HAN_Male_Ogre_BC_2_Goons_Win_01	Macht doch eine Pause, Aya. Hehe. Das würde Euch guttun.	
VO_BOSS_HAN_Male_Ogre_BC_2_Goons_Winning_01	Vielleicht solltet Ihr Eure Lage noch einmal überdenken.	
VO_BOSS_HAN_Male_Ogre_BC_2_Jade_Golem2_01	Diese Jadetypen gehen mir langsam auf die Nerven.	
VO_BOSS_HAN_Male_Ogre_BC_2_Lotus_Win_01	*Gah* Gadgetzan wird_… uns gehören_...	
VO_BOSS_HAN_Male_Ogre_BC_2_Lotus_Winning_01	Könnte sich endlich jemand um diese vorlaute Göre kümmern?!	
VO_BOSS_HAN_Male_Ogre_Concede_01	Das ist alles deine Schuld.	
VO_BOSS_HAN_Male_Ogre_Greetings_01	Willkommen in Gadgetzan, Grünschnabel.	
VO_BOSS_HAN_Male_Ogre_INTRO_PACK_OPEN_7	Hey, hey, hey! Wer ist denn dieser gut aussehende Kerl?	
VO_BOSS_HAN_Male_Ogre_Oops_01	Das ist ungünstig.	
VO_BOSS_HAN_Male_Ogre_START_01	Hier seid Ihr in unserem Revier.	
VO_BOSS_HAN_Male_Ogre_Thanks_01	Ihr habt mir einen großen Gefallen getan.	test
VO_BOSS_HAN_Male_Ogre_Threaten_01	Ich mache Euch ein Angebot, das Ihr nicht ablehnen könnt.	
VO_BOSS_HAN_Male_Ogre_Well_Played_02	Ich muss schon sagen, ich bin beeindruckt, Grünschnabel.	
VO_BOSS_HAN_Male_Ogre_WOW_01	Nicht übel.	
VO_BOSS_KAZAKUS_Male_Troll_BC_0_Potion_01	Ah, wie erfrischend_...	
VO_BOSS_KAZAKUS_Male_Troll_BC_0_Potion_02	Nehmt einen Schluck!	
VO_BOSS_KAZAKUS_Male_Troll_BC_0_Potion_04	Schön austrinken_...	
VO_BOSS_KAZAKUS_Male_Troll_BC_0_Potion_05	Na, wie schmeckt das?	
VO_BOSS_KAZAKUS_Male_Troll_BC_1_1st_Turn_Start_01	Gadgetzan wird mir gehören, Han'Cho!	
VO_BOSS_KAZAKUS_Male_Troll_BC_1_2nd_Turn_Start_01	Die Kabale ist überall! Gadgetzan beugt sich unserer Macht!	
VO_BOSS_KAZAKUS_Male_Troll_BC_1_Arms_Dealing1_01	Hmpf, das ist mal wieder typisch für die Gassenhauer. Hört auf, Euch auf der Hand zu verstecken!	
VO_BOSS_KAZAKUS_Male_Troll_BC_1_Fill1_01	Meine Kabale verfügt über unbegrenzte Macht!	
VO_BOSS_KAZAKUS_Male_Troll_BC_1_Goons_Win_01	Ich werde zurückkehren_... stärker als je zuvor!	
VO_BOSS_KAZAKUS_Male_Troll_BC_1_Goons_Winning_01	Dafür werdet Ihr leiden, Han'Cho_...	
VO_BOSS_KAZAKUS_Male_Troll_BC_1_Kabal_Win_01	Doch. Ist es.	
VO_BOSS_KAZAKUS_Male_Troll_BC_1_Kabal_Winning_01	Euer Schicksal ist bald besiegelt, Han'Cho.	
VO_BOSS_KAZAKUS_Male_Troll_BC_3_1st_Turn_Start_01	Hehehe. Dafür müsst Ihr zunächst mich besiegen_...	
VO_BOSS_KAZAKUS_Male_Troll_BC_3_Fill1_01	IHR SOLLT MICH NICHT SO NENNEN! UNVERSCHÄMTE GÖRE!	
VO_BOSS_KAZAKUS_Male_Troll_BC_3_Fill2_01	Unterwerft Euch der Macht der Kabale!	
VO_BOSS_KAZAKUS_Male_Troll_BC_3_Jade_Golem2_01	Freche Göre! Ihr wagt es, den mächtigsten Anführer in ganz Gadgetzan herauszufordern?	
VO_BOSS_KAZAKUS_Male_Troll_BC_3_Jade_Golem3_01	Dreistes Mädchen! Ich habe genug von Euch und Euren Golems!	
VO_BOSS_KAZAKUS_Male_Troll_BC_3_Kabal_Winning_01	Hehe, Ihr seht ein wenig müde aus, Mädchen.	
VO_BOSS_KAZAKUS_Male_Troll_BC_3_Kabal_Winning_02	Was? Unverschämtes Kind! Ich werde Euer Untergang sein!	test
VO_BOSS_KAZAKUS_Male_Troll_BC_3_Kabal_Wins_01	Haha! Ein weiterer Feind beugt sich der Macht der Kabale!	
VO_BOSS_KAZAKUS_Male_Troll_BC_3_Lotus_Winning_01	Verzogenes Gör!	
VO_BOSS_KAZAKUS_Male_Troll_BC_3_Lotus_Wins_01	Unverschämte Närrin. Das ist noch nicht vorbei_...	
VO_BOSS_KAZAKUS_Male_Troll_BC_3_Potion1_01	Sind wir nicht alle ein bisschen_... Kabale?	
VO_BOSS_KAZAKUS_Male_Troll_Concede_01	Diese Straßen_... sind_... mein_...	
VO_BOSS_KAZAKUS_Male_Troll_Greetings_02	Seid gegrüßt, Ihr Toren.	test
VO_BOSS_KAZAKUS_Male_Troll_Mirror_Start_01	Ihr seid nicht unbegabt.	
VO_BOSS_KAZAKUS_Male_Troll_Oops_01	Eine Fehlentscheidung.	
VO_BOSS_KAZAKUS_Male_Troll_START_01	Folgt dem Ruf des Manas.	
VO_BOSS_KAZAKUS_Male_Troll_Thanks_01	Ich danke Euch, Lakai.	
VO_BOSS_KAZAKUS_Male_Troll_Threaten_01	ICH ALLEIN HERRSCHE ÜBER GADGETZAN!	
VO_BOSS_KAZAKUS_Male_Troll_Well_Played_02	Ich spüre großes Potenzial.	
VO_BOSS_KAZAKUS_Male_Troll_Wow_01	Welche überwältigende Macht!	
VO_BRANN_MITHRIL_ALT_02	Faszinierend. Diese Mithrilrunen enthalten einen Wächtercode. Sie müssen aus der Zeit der Titanen stammen!	
VO_BRANN_WIN_07_ALT_07	Die sind wir los! Das Kopfstück ist in der nächsten Kammer!	
VO_BRM_027h_Death_63	Ahh! AHHH! AAAAHHHHH!	
VO_BRMA01_1_CARD_05	Bereitet ihm einen „warmen Empfang“!	
VO_BRMA01_1_DEATH_09	Oh, ho, ho, hoppla! Das passt mir gar nicht, aber was soll's ...	
VO_BRMA01_1_ETC_06	Und jetzt, etwas Live-Unterhaltung! Begrüßt den Elite Tauren Chieftain!	
VO_BRMA01_1_HERO_POWER_04	Hahaha! Kneipenschlägerei!	
VO_BRMA01_1_RESPONSE_03	Hahaha… hicks! Oh, Entschuldigung.	
VO_BRMA01_1_START_01	Willkommen im Grimmigen Säufer!	
VO_BRMA01_1_SUCCUBUS_08	Herrin Nagmara! Ich denke, unser „Freund“ braucht eine „Erfrischung“.	
VO_BRMA01_1_TURN1_02	Na, sieh einer an ... Alle mal herhören! Wir haben einen „Gast“.	
VO_BRMA01_1_WARGOLEM_07	Oh ho ho! Jetzt habt Ihr aber ein Problem! Phalanx! Schnapp ihn dir!	
VO_BRMA02_1_ALAKIR_34	Wen haben wir denn da? Den Elementarlord, der gerne Insekten zerquetscht – Al'Akir!	
VO_BRMA02_1_ALEXSTRAZA_32	Lebensbinderin, Drachenkönigin, Schlägerin in der Dunkeleisenarena … Alexstrasza!	
VO_BRMA02_1_BEAST_22	Sie isst am liebsten gnomisch, aber sie macht auch mal eine Ausnahme. Ich rede natürlich von der Bestie!	
VO_BRMA02_1_BOOM_28	Ich hoffe, hier sitzt niemand im Explosionsradius, denn unser nächster Herausforderer ist Dr. Bumm!	
VO_BRMA02_1_CAIRNE_20	Sein Sohn soll eines Tages in seine Hufstapfen treten. Macht ein wenig Lärm für Cairne Bluthuf!	
VO_BRMA02_1_CHO_07	Macht Euch bereit für eine Märchenstunde mit einem drolligen Pandaren: Lehrensucher Cho!	
VO_BRMA02_1_DEATH_38	Hm? Ho! Uh! *Röcheln*	
VO_BRMA02_1_DEATHWING_35	Oooh! Meine Damen und Herren! Der echte, der einzig wahre ... TODESSCHWINGE!	
VO_BRMA02_1_ETC_18	Und nun … der Tauren … der Mythos … die Legende – der Elite Tauren Chieftain!	
VO_BRMA02_1_FEUGEN_15	Applaus für Feugen!	
VO_BRMA02_1_FOEREAPER_29	Mechanisch optimiert für maximale Zerstörungskraft: der Feindschnitter 4000!	
VO_BRMA02_1_GEDDON_13	Ah, jetzt wird es kuschlig warm in der Arena! Ein heißes Willkommen für Baron Geddon!	
VO_BRMA02_1_GELBIN_21	Direkt aus Neu-Tüftlerstadt eingetroffen! Heißt seine Gnomheit Gelbin Mekkatorque herzlich willkommen!	
VO_BRMA02_1_GRUUL_31	Er wird nicht umsonst der Drachenschlächter genannt! Applaus für GRUUL!	
VO_BRMA02_1_HERO_POWER_05	Oh, das Publikum ist schon ganz ungeduldig! Haha!	
VO_BRMA02_1_HOGGER_27	Zu ihm sage ich nur so viel: Stufe 11! Ein Gnoll! Der Schrecken von Elwynn: HOGGER!	
VO_BRMA02_1_ILLIDAN_23	Wer braucht schon Augen, wenn man Zwillingskriegsgleven hat? Nicht ILLIDAN STURMGRIMM!	
VO_BRMA02_1_LEVIATHAN_12	Aufpoliert und fertig zum Abwracken: der Flammenleviathan!	
VO_BRMA02_1_LOATHEB_16	Nasenlöcher zustopfen und Mundschutz überziehen ... Hier kommt das faulende Etwas Loatheb!	
VO_BRMA02_1_MAEXXNA_24	Es ist… Ihr wisst schon, die große Spinne! Wie spricht man ihren Namen noch mal aus? MAEXXNA!	
VO_BRMA02_1_MILLHOUSE_09	Ach, kommt schon. Wer hat denn den in die Arena gelassen?	
VO_BRMA02_1_MOGOR_25	Sein Vokabular ist begrenzt, aber seine Wut nicht. Es ist ... Mogor der Oger!	
VO_BRMA02_1_MUKLA_10	Als Nächstes erwartet uns der Bananenmeister selbst: König Mukla!	
VO_BRMA02_1_NOZDORMU_36	Meine Damen und … ups! Keine Zeit mehr!	
VO_BRMA02_1_ONYXIA_33	Direkt aus den Düstermarschen über Sturmwind hierher eingeflogen – ONYXIA!	
VO_BRMA02_1_PAGLE_08	Gerade von seinem letzten Angeltrip zurück: Meisterangler Nat Pagle!	
VO_BRMA02_1_RESPONSE_04	Keiner kann gegen all diese Legenden bestehen!	
VO_BRMA02_1_SNEED_30	Unser nächster Herausforderer versteckt sich hinter dem Steuerpult eines alten Schredders! Wer könnte es bloß sein?	
VO_BRMA02_1_STALAGG_14	Kann Stalagg die Arena überleben? Finden wir es heraus!	
VO_BRMA02_1_START_01	Ein neuer Herausforderer!	
VO_BRMA02_1_SYLVANAS_19	Ihr Herz brennt mit ewigem Hass, ganz allein für Euch – begrüßt Sylvanas Windläufer!	
VO_BRMA02_1_THALNOS_06	Applaus für das Skelett im Abendkleid: Blutmagier Thalnos!	
VO_BRMA02_1_THAURISSAN_37	Er hat extra den weiten Weg von der nächsten Mission hierher zurückgelegt: Imperator Thaurissan!	
VO_BRMA02_1_TINKMASTER_11	Eine Runde Applaus für den großen Erfinder Tüftlermeister Oberfunks!	
VO_BRMA02_1_TOSHLEY_26	Dieser Gnom steht ständig unter Strom. Herzlich Willkommen, Toshley!	
VO_BRMA02_1_TURN1_02	Meine Damen und Herren Zwerge! Heute bieten wir eine Mordsshow!	
VO_BRMA02_1_TURN1_PT2_03	Die größten Legenden Azeroths gegen einen einzigen Abenteurer!	
VO_BRMA02_1_VOLJIN_17	Ruhe bitte! Wir haben einen besonderen Gast: Kriegshäuptling Vol'jin höchstpersönlich!	
VO_BRMA03_1_CARD_04	Bei der Macht von Ragnaros, ich habe die Kraft!	
VO_BRMA03_1_DEATH_09	Aaaaaah!	
VO_BRMA03_1_HERO_POWER_06	STERBT!!!	
VO_BRMA03_1_MOIRA_DEATH_05	Nein! Moira! Dafür werdet Ihr bezahlen!	
VO_BRMA03_1_RESPONSE_03	Haltet den Mund, sonst stopf ich ihn Euch!	
VO_BRMA03_1_START_01	Die Dunkeleisenzwerge werden niemals untergehen!	
VO_BRMA03_1_TURN1_02	Heda! Lasst meine Frau in Ruhe!	
VO_BRMA03_1_VS_RAG_07	Nein! Ragnaros? NICHT SCHON WIEDER!	
VO_BRMA04_1_CARD_04	Bringen wir den Stein ins Rollen.	
VO_BRMA04_1_DEATH_06	Rrrrrrrh!	
VO_BRMA04_1_HERO_POWER_05	Magma!	
VO_BRMA04_1_RESPONSE_03	Stein schlägt alles.	
VO_BRMA04_1_START_01	Bei mir werdet Ihr auf Granit beißen.	
VO_BRMA04_1_TURN1_02	Es ist Steinzeit.	
VO_BRMA05_1_CARD_05	Die Bombe tickt, Sterblicher!	
VO_BRMA05_1_DEATH_04	Ein letzter Dienst …	
VO_BRMA05_1_HERO_POWER_06	Brennt!	
VO_BRMA05_1_RESPONSE_03	Armageddon!	
VO_BRMA05_1_START_01	Ihr werdet brennen!	
VO_BRMA05_1_TURN1_02	Ragnaros wird Euch verzehren!	
VO_BRMA06_1_DEATH_04	Ich gebe auf! Ich gebe auf!	
VO_BRMA06_1_RESPONSE_03	Ihr glaubt also, Ihr hättet schon gewonnen? Mir scheint, dass Ihr noch eine Lektion in Sachen Schmerz braucht!	
VO_BRMA06_1_START_01	Niemand fordert die Lebende Flamme heraus!	
VO_BRMA06_1_SUMMON_RAG_05	Seht Ragnaros! Er, der schon uralt war, als Eure Welt noch jung war!	
VO_BRMA06_1_TURN1_02_ALT	Vernichtet diesen Eindringling!	
VO_BRMA06_3_INTRO_01	ZU FRÜH! IHR HABT MICH ZU FRÜH ERWECKT, EXEKUTUS!	
VO_BRMA06_3_RESPONSE_03	WAS HAT DIESE STÖRUNG ZU BEDEUTEN?	
VO_BRMA06_3_TURN1_02	STERBLICHE INSEKTEN! IHR WAGT ES, IN MEIN REICH EINZUDRINGEN?	
VO_BRMA07_1_CARD_04	Zeit zum Hauen!	
VO_BRMA07_1_DEATH_06	Rrrneeeein!	
VO_BRMA07_1_HERO_POWER_05	Ich hauen! Ihr sterben!	
VO_BRMA07_1_RESPONSE_03	Raaar! Ich hauen!	
VO_BRMA07_1_START_01	Ich Euch zerquetschen!	
VO_BRMA07_1_TURN1_02	Hngh. Zerquetschen oder tothauen? Schwere Entscheidung!	
VO_BRMA08_1_CARD_05	Ich werde die Schwarzfelsspitze verteidigen!	
VO_BRMA08_1_DEATH_06	Aaaargh!	
VO_BRMA08_1_RESPONSE_04	Warum? Warum nur? Ich fand Euch doch ganz nett.	
VO_BRMA08_1_START_01	Was treibt Ihr denn hier?	
VO_BRMA08_1_TURN1_03	Lord Nefarius! Ich dachte, der hier hat sich für uns um Ragnaros gekümmert!	
VO_BRMA08_1_TURN1_ALT_02	Wollt Ihr mir bei der Vernichtung der Sterblichen dieser Welt behilflich sein?	
VO_BRMA09_1_CARD_05	Die Schwarzfelsspitze gehört uns!	
VO_BRMA09_1_DEATH_11	Gaaahhhhh!	
VO_BRMA09_1_HERO_POWER1_06	Öffnet die Tore!	
VO_BRMA09_1_HERO_POWER2_07	Tötet den da hinten.	
VO_BRMA09_1_HERO_POWER3_08	Konzentriert euch auf den Helden, Ihr Narren!	
VO_BRMA09_1_HERO_POWER4_09	Zusammen sind wir unaufhaltsam!	
VO_BRMA09_1_RESPONSE_04	Hahaha!	
VO_BRMA09_1_START_01	Wir sind die wahre Horde!	
VO_BRMA09_1_TURN1_03	Ihr klettert den falschen Berg hinauf.	
VO_BRMA09_1_TURN1_ALT_02	Niemand hält uns auf! STERBT!	
VO_BRMA10_1_DEATH_08	Rrrrrrrh!	
VO_BRMA10_1_EGG_DEATH_1_05	Narren! Diese Eier sind wertvoller, als Ihr glaubt!	
VO_BRMA10_1_EGG_DEATH_2_06	Nein! Nicht noch eines! Für diese Gräueltat werde ich mir Eure Köpfe holen!	
VO_BRMA10_1_EGG_DEATH_3_07	Dafür werdet Ihr bezahlen!	
VO_BRMA10_1_HERO_POWER_04	Bleibt von den Eiern fern!	
VO_BRMA10_1_RESPONSE_03	Aus Euch mache ich Rührei!	
VO_BRMA10_1_START_01	Seht! Die verderbten Eier unseres neuen Drachenschwarms!	
VO_BRMA10_1_TURN1_02	Diese Eier werden Euer Untergang sein!	
VO_BRMA11_1_ALEXSTRAZA_07	Alexstrasza, hilf mir!	
VO_BRMA11_1_CARD_04	Die Wut des Schwarzfels pulsiert durch meine Adern!	
VO_BRMA11_1_DEATH_ALT_08	Endlich endet mein Schmerz …	
VO_BRMA11_1_HERO_POWER_05	Aaaah! Zerstörung!	
VO_BRMA11_1_KILL_PLAYER_06	Vergebt mir! Ich habe versagt.	
VO_BRMA11_1_RESPONSE_03	Ihr hättet fliehen sollen, solange Ihr noch konntet, Sterblicher!	
VO_BRMA11_1_START_01	Flieht, bevor ich endgültig die Kontrolle verliere!	
VO_BRMA11_1_TURN1_02	Zu spät … Nefarians üble Macht wirkt bereits!	
VO_BRMA13_1_DEATH_ALT_23	Nein! NEEIIN! ICH WERDE ZURÜCKKOMMEN!	
VO_BRMA13_1_DEATHWING_19	PAPA?	
VO_BRMA13_1_HP_DRUID_14	Druide, die Wildnis untersteht nun meinem Befehl!	
VO_BRMA13_1_HP_GENERIC_18	Eure Magie gehört mir!	
VO_BRMA13_1_HP_HUNTER_12	Der Jäger wird zum Gejagten!	
VO_BRMA13_1_HP_MAGE_11	Magier, Ihr solltet vorsichtiger sein, wenn Ihr mit Magie spielt ...	
VO_BRMA13_1_HP_PALADIN_07	Paladin, hat Euch das Licht etwa verlassen?	
VO_BRMA13_1_HP_PRIEST_08	Priester, das Licht dient nun MIR!	
VO_BRMA13_1_HP_ROGUE_15	Schurke! Kommt aus den Schatten und zeigt Euch!	
VO_BRMA13_1_HP_SHAMAN_13	Schamane, die Elemente gehorchen nun MIR.	
VO_BRMA13_1_HP_WARLOCK_10	Hexenmeister, Ihr solltet nicht mit Magie spielen, die Ihr nicht versteht!	
VO_BRMA13_1_HP_WARRIOR_09	Krieger, Eure Stärke ist nun Eure Schwäche!	
VO_BRMA13_1_RESPONSE_05	Ich bin hier der Meister!	
VO_BRMA13_1_START_01	Willkommen in meinem Sanktum, Held.	
VO_BRMA13_1_TURN1_PT1_02	Seht! Die wahre Macht NEFARIANS!	
VO_BRMA13_1_TURN1_PT2_03	Unendlich viel Mana! Verstärkte Drachenschuppen!	
VO_BRMA14_1_CARD_09	Umleitung überschüssiger Energie.	
VO_BRMA14_1_DEATH_08	Verteidigungssysteme zerstört. Schalte ab ...	
VO_BRMA14_1_HP1_03	Elektroneinheit aktiviert.	
VO_BRMA14_1_HP2_04	Toxitroneinheit aktiviert.	
VO_BRMA14_1_HP3_05	Arkanotroneinheit aktiviert.	
VO_BRMA14_1_HP4_06	Magmatroneinheit aktiviert.	
VO_BRMA14_1_HP5_07	Verteidigungseinheit online.	
VO_BRMA14_1_RESPONSE1_10	Biip buup biip.	
VO_BRMA14_1_RESPONSE2_11	Verbindung wird aufgebaut …	
VO_BRMA14_1_RESPONSE3_12	Verbindung erfolgreich. Betriebssystem-Updates werden heruntergeladen.	
VO_BRMA14_1_RESPONSE4_13	Updates installiert. Hallo! Hallo! Hallo!	
VO_BRMA14_1_RESPONSE5_14	Hallo! Hallo! Hallo!	
VO_BRMA14_1_START_01	Eindringlinge entdeckt.	
VO_BRMA14_1_TURN1_02	Primäres Verteidigungssystem aktiviert.	
VO_BRMA15_1_CARD_05	Meine Fehlschläge sind Euer Tod!	
VO_BRMA15_1_DEATH_04	Aaaaahhh!	
VO_BRMA15_1_HERO_POWER_06	Vermischen! Rühren! Erhitzen!	
VO_BRMA15_1_RESPONSE_03	Nichts wird verschwendet!	
VO_BRMA15_1_START_01	Keine Unterbrechungen!	
VO_BRMA15_1_TURN1_02	Der Meister wartet nicht. Kein Versagen diesmal!	
VO_BRMA16_1_CARD_04	Ihr könnt Euch nicht verstecken.	
VO_BRMA16_1_DEATH_06	Rrraaaaaah!	
VO_BRMA16_1_GONG1_10	Aaaah! Dieses Geräusch!	
VO_BRMA16_1_GONG2_11	Nein! Nicht so nah!	
VO_BRMA16_1_GONG3_12	Meine OHREN!	
VO_BRMA16_1_HERO_POWER_05	Euer plumpes Getrampel und Euer Gestank verraten Euch!	
VO_BRMA16_1_RESPONSE_03	Ja, sprecht nur, ich komme näher!	
VO_BRMA16_1_START_01	Ich höre Euer kleines Herz schlagen!	
VO_BRMA16_1_TRIGGER1_07	Ah, ich kann Euch hören …	
VO_BRMA16_1_TRIGGER2_08	Ich höre Schritte.	
VO_BRMA16_1_TRIGGER3_09	Ich höre Euer Herz klopfen … Es gibt kein Entkommen!	
VO_BRMA16_1_TURN1_02	Der Tod lauert im Dunkel.	
VO_BRMA17_1_CARD_86	Ich hoffe, Ihr könnt schwimmen … in geschmolzener Lava!	
VO_BRMA17_1_DEATH_97	Aaaaah!	
VO_BRMA17_1_DEATH_HEROIC_98	NEEEIIIIN!	
VO_BRMA17_1_DEATHWING_88	PAPA?	
VO_BRMA17_1_HERO_POWER_87	Seht, wie die Schattenflamme ihre Knochen mit Leben erfüllt!	
VO_BRMA17_1_NEF_AIR1_89	Werdet Zeuge meiner feurigen Wut! 1 Schaden ist aber erst der Anfang!	
VO_BRMA17_1_NEF_AIR2_90	Zwei Feuerbälle! Vielleicht solltet Ihr den Kopf einziehen!	
VO_BRMA17_1_NEF_AIR3_91	Dieses Mal gibt es nur einen einzigen Feuerball, denn ich bereite mich auf einen EPISCHEN Zug vor.	
VO_BRMA17_1_NEF_AIR4_92	OHO! DREI FEUERBÄLLE! NEHMT DAS! AUS DER LUFT!	
VO_BRMA17_1_NEF_AIR5_93	Von nun an werde ich nur einen Feuerball spucken!	
VO_BRMA17_1_NEF_AIR6_94	KLEINER SCHERZ! VIER FEUERBÄLLE! HAHAHAHA!	
VO_BRMA17_1_NEF_AIR7_95	Dieses Mal spucke ich keine Feuerbälle. Aber macht Euch bereit …	
VO_BRMA17_1_NEF_AIR8_96	ZWANZIG FEUERBÄLLE! BAHAHAHAHA!	
VO_BRMA17_1_RESPONSE_85	Sterbliche … so leicht zu manipulieren.	
VO_BRMA17_1_RESURRECT1_82	Ich werde Tod und Zerstörung auf Euch niederregnen lassen!	
VO_BRMA17_1_RESURRECT2_83	Während ich mir hier oben ein Päuschen gönne, wartet auf Euch dort unten eine Überraschung!	
VO_BRMA17_1_RESURRECT3_84	So sehet denn meine ultimative Schöpfung! Erhebe dich, Schwester! Erhebe dich, Onyxia!	
VO_BRMA17_1_START_78	Ihr habt es also ins große Finale geschafft!	
VO_BRMA17_1_TRANSFORM1_80	Ich habe versucht ein guter Gastgeber zu sein, aber Ihr wollt einfach nicht sterben.	
VO_BRMA17_1_TRANSFORM2_81	Genug der Spielchen! Ich werde Euch einfach ... TÖTEN!	
VO_BRMA17_1_TURN1_79	Meine ultimative Schöpfung erwartet Euch, Sterblicher.	
VO_COOP02_00	Ich werde Euch beide vom Fluch des Fleisches befreien!	
VO_COOP02_02	Besiegt Ritzelmeister Mechazod gemeinsam, um zu gewinnen!	
VO_COOP02_ABILITY_05	Erhöhe Taktgeschwindigkeit!	
VO_COOP02_ABILITY_06	Ihr seid ein Relikt der Vergangenheit, Lehrensucher Cho!	
VO_COOP03_01	Ich bin hier der Meister!	
VO_COOP03_02	Nein_... NEIN! Ich werde Euch vernichten!	
VO_COOP03_03	Sterbliche_… so leicht zu manipulieren.	
VO_COOP03_04	Ich habe versucht ein guter Gastgeber zu sein, aber Ihr wollt einfach nicht sterben!	
VO_COOP03_05	Genug der Spielchen! Ich werde Euch einfach ... TÖTEN!	
VO_COOP03_06	Priester, das Licht dient nun MIR!	
VO_COOP03_07	Schamane, die Elemente gehorchen nun MIR.	
VO_COOP03_08	Hahahaha_... Seht! Die wahre Macht NEFARIANS!	
VO_COOP03_09	Hahahaha_... Ihr habt es also ins große Finale geschafft!	
VO_Crone_Female_Troll_CroneDeath_02	Nein! Ich kriege dich! Ich krieeeeege...	
VO_Crone_Female_Troll_CroneEmoteResponse_02	Ahahahaha!	
VO_Crone_Female_Troll_CroneFlyingMonkeys_01	Bringt mir das Mädchen!	
VO_Crone_Female_Troll_CroneHeroPower_02	Hehehehe!	
VO_Crone_Female_Troll_CroneOpen_01	Hahahaha! Flieht, meine Hübschen!	
VO_Curator_Male_ArcaneGolem_CuratorArcaneGolem_01	Seltsam. Eine erstaunliche Ähnlichkeit.	
VO_Curator_Male_ArcaneGolem_CuratorBeasts_01	Der Kurator ist allergisch gegen Wildtiere.	
VO_Curator_Male_ArcaneGolem_CuratorDemons_01	Dämonen haben nichts zu suchen in der Menagerie.	
VO_Curator_Male_ArcaneGolem_CuratorDragons_01	Nie wieder Drachengehege ausmisten! 	
VO_Curator_Male_ArcaneGolem_CuratorEmoteResponse_01	Eure Anfrage kann nicht bearbeitet werden.	
VO_Curator_Male_ArcaneGolem_CuratorHarrison_02	Langfinger entdeckt! Harrison Jones hat keinen Zutritt.	
VO_Curator_Male_ArcaneGolem_CuratorMechs_01	Assistenten werden umprogrammiert.	
VO_Curator_Male_ArcaneGolem_CuratorMedivhSkin_01	Falscher Medivh. Leuchtende Augen entlarven Betrug.	
VO_Curator_Male_ArcaneGolem_CuratorMurlocs_01	Setze winzige Fischkreaturen frei.	
VO_Curator_Male_ArcaneGolem_CuratorPirates_01	Piraten: bereit machen zum Entern.	
VO_Curator_Male_ArcaneGolem_CuratorReno_02	Langfinger entdeckt! Reno Jackson hat keinen Zutritt.	
VO_Curator_Male_ArcaneGolem_CuratorTurn1_01	Kurator bereit zur Menagerieverwaltung.	
VO_Curator_Male_ArcaneGolem_CuratorTurn5_01	Die Verhaltensregeln für die Galerie sind unbedingt einzuhalten.	
VO_Curator_Male_ArcaneGolem_CuratorTurn9_01	Gäste dürfen sich nur in der Menagerie aufhalten.	
VO_Curator_Male_ArcaneGolem_IllhoofKilrekResponse_01	Für den Kurator ist diese Frage irrelevant. Beschwörungen sind verboten.	
VO_Curator_Male_ArcaneGolem_IllhoofSenseDemons_01	Viele Dämonen registriert.	
VO_Curator_Male_ArcaneGolem_IllhoofTurn1_01	Beschwörungsrituale sind nicht zulässig.	
VO_Curator_Male_ArcaneGolem_IllhoofTurn5_01	Rituale können Exponate schädigen. Der Dämon muss aufgehalten werden.	
VO_Curator_Male_ArcaneGolem_IllhoofWin_01	Der Kurator dankt Euch. Die Menagerie wird restauriert werden.	
VO_Curator_Male_ArcaneGolem_NightbaneCorruption_01	Nein! Die Menagerie darf nicht verderbt werden!	
VO_Curator_Male_ArcaneGolem_NightbaneTour_01	Schrecken der Nacht. Spezies: Drache. Einst bekannt als Arcanagos. Unkontrollierte Magie trieb ihn in den Wahnsinn.	
VO_Curator_Male_ArcaneGolem_NightbaneTour_02	Zu Eurer Linken, eine Büste von Aran. Zu Eurer Rechten, die Laterne der Macht.	
VO_Curator_Male_ArcaneGolem_NightbaneTurn1_01	Freigesetzte Exponate könnten beschädigt werden. Sie gehören zurück in die Menagerie.	
VO_Curator_Male_ArcaneGolem_NightbaneTurn3_01	Die Kreaturen müssen gerettet werden. Erst danach könnt Ihr fortfahren.	
VO_Curator_Male_ArcaneGolem_NightbaneUnstablePortal_01	Vorsicht ist geboten. Der Drache ist empfindlich gegen instabile Magie.	
VO_Curator_Male_ArcaneGolem_NightbaneWin_01	Weitere Unterstützung benötigt.	
VO_Curator_Neither_ArcaneGolem_CuratorDeath_04	Fahre herunteeeeer...	
VO_Curator_Neither_ArcaneGolem_CuratorOpen_01	Fasst die Schaukästen nicht an!	
VO_ELISE_LOE16_ALT_1_FIRST_HALF_02	Während der Stab sich auflädt, ist Rafaam unverwundbar.	
VO_ELISE_LOE16_ALT_1_SECOND_HALF_03	Danach können wir ihn für kurze Zeit angreifen – wenn wir an der beschworenen Kreatur vorbeikommen!	
VO_ELISE_WEIRD_DECK_05	Ich muss mich für das Deck entschuldigen. Wir haben es letztes Jahr für ein Turnier erstellt und seitdem nicht angepasst.	
VO_EMOTE_HERO_TBKTRAF_KT_DRAWING_BOARD	*seufz* Und noch mal von vorne.	
VO_EMOTE_HERO_TBKTRAF_KT_GLOAT	Betet um Gnade!	
VO_EMOTE_HERO_TBKTRAF_KT_MINIONS_SERVANTS	Lakaien, Diener, Soldaten der eisigen Finsternis ...	
VO_FP1_014t_EnterPlay_01	Jetzt spürt IHR den Schmerz ...	
VO_FP1_031_Attack_07	Lämmer zur Schlachtbank ...	
VO_FP1_031_EnterPlay_06	Die Geißel wird Euch verzehren!	
VO_HRW_DEBUG_01	1	
VO_HRW_DEBUG_02	2	
VO_HRW_DEBUG_03	3	
VO_HRW_DEBUG_04	4	
VO_HRW_DEBUG_05	5	
VO_HRW_TEST_00	Ich werde Euch beide vom Fluch des Fleisches befreien!	
VO_HRW_TEST_01	Gute Arbeit! Ihr haben den Boss zusammen besiegt.\n\nBeide Spieler gewinnen!	
VO_HRW_TEST_02	Besiegt Ritzelmeister Mechazod gemeinsam, um zu gewinnen!	
VO_HRW_TEST_ABILITY_00	Füge einem Helden Schaden zu.	
VO_HRW_TEST_ABILITY_01	Vernichte den Diener mit dem höchsten Angriff.	
VO_HRW_TEST_ABILITY_02	Werfe 3 Bomben.	
VO_HRW_TEST_ABILITY_03	Füge allen anderen Charakteren Schaden zu.	
VO_HRW_TEST_ABILITY_04	Erhalte 2 Angriff.	
VO_HRW_TEST_ABILITY_05	Füge beiden Helden Schaden zu.	
VO_HRW_TEST_ABILITY_06	Bringe Lehrensucher Cho zum Schweigen. Dauerhaft.	
VO_HRW_TEST_ABILITY_98	Zielbrett ist voll. Räume Zielbrett.	
VO_Illhoof_Male_Demon_IlhoofKilrek_01	Nun denn, Kil'rek. Schließen wir die Beschwörung ab!	
VO_Illhoof_Male_Demon_IllhoofDeath_02	Nein! Beinahe! Sarger...	
VO_Illhoof_Male_Demon_IllhoofEmoteResponse_01	Eure Essenz nährt das Ritual!	
VO_Illhoof_Male_Demon_IllhoofOpen_01	Ah, Ihr kommt genau richtig.	
VO_Illhoof_Male_Demon_IllhoofSummonImps_01	Kommt, ihr Kreaturen der Dunkelheit, folgt meinem Ruf!	
VO_Illhoof_Male_Demon_IllhoofSummoningPortal_01	Ein Portal ohne Ritual? Hm, das macht das Ganze so viel einfacher_...	
VO_Illhoof_Male_Demon_IllhoofTurn1_01	Das Ritual beginnt_... jetzt!	
VO_Illhoof_Male_Demon_IllhoofWounded_01	Kommt herbei, meine Tierchen. Das Ritual muss abgeschlossen werden!	
VO_Jaraxxus_Male_Demon_FinalMalchezaarJaraxxus_01	Einfältiger Prinz. Übt Euch lieber in Karaoke wie Jaraxxus!	
VO_Jaraxxus_Male_Demon_FinalMalchezaarJaraxxus_02	Hört Ihr den Ruf? Ihr seid am Zug, stellt Euch Gefahr'n und Ungeheuern!	
VO_Julianne_Female_Human_JulianneDeath_01	Romulo! Dies trink ich dir!	
VO_Julianne_Female_Human_JulianneEmoteResponse_01	Bohrt Ihr uns einen Esel?	
VO_Julianne_Female_Human_JulianneFeignDeath_03	Und dann erwachen wie von süßem Schlaf.	
VO_Julianne_Female_Human_JulianneHeroPower_01	Komm, milde, liebevolle Nacht! Komm, gib mir meinen Romulo zurück!	
VO_Julianne_Female_Human_JulianneOpen_01	Welch Teufel bist du?	
VO_KAR03_MOROES_MALE_HUMAN_CHESS_TURN_1	Figuren greifen automatisch am Ende Eures Zuges an.	
VO_KAR03_MOROES_MALE_HUMAN_CHESS_TURN_3	Wenn sich eine Figur zwischen zwei Feinden befindet, schlägt sie beide!	
VO_KAR03_MOROES_MALE_HUMAN_CHESS_TURN_5	Die richtige Stellung ist der Schlüssel zum Erfolg. Versucht, möglichst oft Doppelangriffe auszuführen!	
VO_KARA_04_01_Female_Human_CroneHuffer_01	Grummel, ich hab das Gefühl, wir sind nicht mehr in Westfall_...	
VO_KARA_04_01_Female_Human_CroneLionTigerBear_02	Oh, Löwen und Drachen und Bären! Oh weh!	
VO_KARA_04_01_Female_Human_CroneTurn1_01	Oh nein, lasst nicht zu, dass sie mir wehtut!	
VO_KARA_04_01_Female_Human_CroneTurn3_01	Hakt Euch bei einander ein! Gemeinsam sind wir stärker!	
VO_KARA_06_01_Male_Human_JulianneDeadlyPoison_02	Ah, eine Dose Gift.	
VO_KARA_06_01_Male_Human_JulianneTurn1_01	Willst du mich zwingen? Sieh dich vor!	
VO_KT_ANTI_CHEESE1_65	Das ist Naxxramas auf Heroisch. Solch erbärmliche Taktiken werden hier nicht geduldet.	
VO_KT_ANTI_CHEESE2_66	Ein Untergangsverkünder? Ihr haltet Euch wohl für sehr schlau.	
VO_KT_ANTI_CHEESE3_67	Gleichheit? Nicht mit mir.	
VO_KT_ANUB2_43	NEIN! Äh, ich meine ... unerheblich. Ihr werdet die Großwitwe niemals besiegen.	
VO_KT_BARON2_64	Das Militärviertel hat versagt! Die Miliz ist auch nicht mehr das, was sie mal war.	
VO_KT_FAERLINA2_45	Faerlinas Tod ist unwichtig. Die Spinnenkönigin wird Euch mit Leichtigkeit eliminieren.	
VO_KT_GLUTH2_73	Ich habe die Zombies gefragt, ob sie Euer Gehirn essen wollen, doch sie meinten, sie essen keine minderwertige Kost. Hahahaha!	
VO_KT_GLUTH2_ALT_74	Es gibt einen Erfolg dafür, gegen Gluth zu verlieren. Ich bin mir da ziemlich sicher.	
VO_KT_GLUTH3_75	HAHAHA! Es gibt doch keinen Erfolg dafür, gegen Gluth zu verlieren!	
VO_KT_GLUTH4_76	Nein! Wer wird jetzt alle meine überschüssigen Zombies fressen?	
VO_KT_GLUTH5_77	Am allerliebsten dezimiere ich Abenteurer. Moment, nein. Ihnen das Blut in den Adern gefrieren zu lassen, mag ich noch lieber!	
VO_KT_GLUTH6_78	Braves Hündchen!	
VO_KT_GOTHIK2_62	Warum kehrt Gothik eigentlich nicht als spektraler Gothik zurück? Was soll das?	
VO_KT_GROBBULUS2_71	Und noch mal von vorne ...	
VO_KT_HEIGAN2_55	Ich BRODLE vor Wut.	
VO_KT_LOATHEB2_57	Ihr tötet immer meine Diener! Hört auf! Hört sofort damit auf!	
VO_KT_MAEXXNA2_47	Dank ihres Gifts werdet Ihr einen relativ schmerzlosen Tod erleiden.	
VO_KT_MAEXXNA3_48	Ein Meeresriese? Maexxna, diese Karte war nicht auf der Liste, die ich genehmigt hatte!	
VO_KT_MAEXXNA4_49	Unmöglich! Dieser Kampf ist noch nicht vorbei, sterblicher Winzling!	
VO_KT_MAEXXNA6_51	Wie bezeichnet man einen Spieler, dessen Diener gerade eingesponnen wurde? Wehrlos.	
VO_KT_NOTH2_53	Armer Noth. Er wollte doch nur helfen, wo *Not* am Mann war.	
VO_KT_PATCHWERK2_69	Mein Abgesandter des Krieges! Ich hätte ihn wohl doch aus besseren Abenteurern zusammennähen sollen ...	
VO_KT_RAZUVIOUS2_59	Wer wird jetzt meine Todesritter ausbilden? Ich kann nicht, ich bin TOTAL beschäftigt.	
VO_KT_SAPPHIRON2_84	Schaut Euch nur diesen kleinen Gnom an. Er dachte auch mal, es wäre eine gute Idee, hier hineinzuschleichen.	
VO_KT_SAPPHIRON3_85	Versteckt Euch nicht immer hinter diesem Eisblock!	
VO_KT_SAPPHIRON4_ALT_87	Saphiron, führe den Plan „Das Blut in ihren Adern gefrieren lassen“ aus!	
VO_KT_SAPPHIRON5_88	Mein Drache! Das war nicht nett.	
VO_KT_THADDIUS2_81	Eindringling! Ich lasse mir diese Dreistigkeit nicht mehr gefallen!	
VO_LOE_01_DEATH_2	Orsis! Rächt mich!	
VO_LOE_01_RESPONSE	Seht den Zorn der Sonne!	
VO_LOE_01_STAFF	Haha! Meins!	
VO_LOE_01_STAFF_2	Ihr werdet brennen!	
VO_LOE_01_STAFF_2_RENO	Ihr solltet den Schaft besser nicht verlieren. Er ist wertvoll.	
VO_LOE_01_START	Ich bin UNBESIEGBAR!	
VO_LOE_01_WIN	Hahaha! Ich habe den Schaft – wenn Harrison mich jetzt doch nur sehen könnte!	
VO_LOE_01_WIN_2	Schnappt Euch den Schaft!	
VO_LOE_01_WIN_2_ALT_2	Äh, ist das normal, dass der Boden so bebt?	
VO_LOE_01_WOUNDED	Haha, der liegt schon in den Seilen! Gebt ihm den Rest!	
VO_LOE_02_DEATH	Zurück in die Lampe? Neeeeeiiin!	
VO_LOE_02_INTRO	Der Schaft der Sonne gehört MIR!	
VO_LOE_02_MORE_WISHES	Wow, ich kann kaum fassen, dass das geklappt hat.	
VO_LOE_02_PHAERIX_STAFF_RECOVER	Ihr habt keine Vorstellung von der Macht des Schaftes!	
VO_LOE_02_RESPONSE	Phänomenale kosmische Macht!	
VO_LOE_02_START	Endlich frei! Als Belohnung gewähre ich Euch einen schnellen Tod.	
VO_LOE_02_START2	Abenteurer! Ich bin Reno Jackson, weltbekannter Archäologe, Forscher und Jäger verlorener Schätze.	
VO_LOE_02_START3	Mit der Selbstbeherrschung einer Elster.	
VO_LOE_02_TURN_10	Stellt Euch nur vor, der Schaft der Sonne! Der ist bestimmt ein hübsches Sümmchen wert.	
VO_LOE_02_TURN_6	Habe ich Euch jemals davon erzählt, wie ich als Oger verkleidet den Düsterbruch infiltriert habe?	
VO_LOE_02_TURN_6_2	Oder davon, wie ich mich durchs Lyzeum im Schwarzfels geschlichen habe, auf der Suche nach ...	
VO_LOE_02_WIN	Weiter! Der Schaft befindet sich gleich hinter diesem Durchgang!	
VO_LOE_02_WISH	Es ist wirklich nett, dass er uns Wünsche erfüllt, während er versucht, uns zu töten.	
VO_LOE_03_RESPONSE	Schneller!	
VO_LOE_03_TURN_1	Die Decke stürzt ein, Monster überall! Beeilt Euch!	
VO_LOE_03_TURN_10	Wir sind fast da! Ich kann die Sonne schon sehen!	
VO_LOE_03_TURN_2	Hey, ein leuchtender Teich. Seid Ihr auch neugierig?	
VO_LOE_03_TURN_2_2	Dafür ist keine Zeit!	
VO_LOE_03_TURN_3	Hmm, okay. Rechts oder links?	
VO_LOE_03_TURN_3_BOULDER	Dieser Felsbrocken ist riesig … Aus dem Weg!	
VO_LOE_03_TURN_3_WARNING	Gut, das Gepolter wird schlimmer ... Ich wette, in der nächsten Runde stürzt uns die Decke auf den Kopf!	
VO_LOE_03_TURN_4	Hey, eine Stachelgrube!	
VO_LOE_03_TURN_4_BAD	Oh ho ho ho! Das hat bestimmt keinen Spaß gemacht.	
VO_LOE_03_TURN_4_GOOD	Hey, nicht schlecht! Fast so elegant wie ich.	
VO_LOE_03_TURN_4_NEITHER	Okay, Ihr wollt mitten durch die Stacheln? Dann aber los!	
VO_LOE_03_TURN_5	Hey, das ist ja eine hübsche Statue. Und der Rubin funkelt so schön …	
VO_LOE_03_TURN_5_4	Oh oh, der sieht aber gar nicht glücklich aus. Ich glaube, er möchte sein Juwel zurück.	
VO_LOE_03_TURN_6	Achtung! Die Decke stürzt ein!	
VO_LOE_03_TURN_6_2	Puh, das war knapp! Gut, dass ich Euch noch retten konnte. Nichts zu danken.	
VO_LOE_03_TURN_7	Hmm, ist ganz schön dunkel da drinnen … aber so finden wir bestimmt schneller hinaus. Auf geht's!	
VO_LOE_03_TURN_7_2	Auf meiner Karte steht da nur in Großbuchstaben „HIER AUF KEINEN FALL HINGEHEN“.	
VO_LOE_03_TURN_8	Puh! Es wird ganz schön warm hier! Beeilung!	
VO_LOE_03_TURN_9	Uäh. Warum muss es IMMER Ungeziefer sein?	
VO_LOE_03_WIN	Ha. Wir haben's geschafft! Ich hätte nie gedacht, dass ich mich freuen würde, diese Wüste zu sehen!	
VO_LOE_04_RESPONSE	Trogg hauen Dummkopf!	
VO_LOE_04_SCARVASH_TURN_2	Trogg nicht dumm! Trogg machen dich dumm!	
VO_LOE_04_START	Uldaman nur für Troggs!	
VO_LOE_04_WIN	Da sind noch mehr von denen! Hier entlang, schnell ab in die Lore!	
VO_LOE_07_RESPONSE	Habt Ihr dafür wirklich Zeit?	
VO_LOE_07_START	Vorsicht, wir werden verfolgt!	
VO_LOE_07_WIN	Ha ha! Loren fahren und dabei Bomben werfen! Das ist der Knaller!	
VO_LOE_08_ANIMATE_STONE	Erde und Stein, erhebt Euch!	
VO_LOE_08_LANDSLIDE	Ich werde Euch begraben!	
VO_LOE_08_RESPONSE	Ihr seid nur Staub.	
VO_LOE_08_START	Wer wagt es, den Zorn der Schöpfer auf sich zu ziehen?	
VO_LOE_08_WIN	Das Kopfstück ist unser! Es fehlt nur noch ein Teil!	
VO_LOE_092_Attack_02	Seht!	
VO_LOE_10_NYAH	Mrrrglmrrrgl nyah!	
VO_LOE_10_RESPONSE	Mrglmrrglrmrrgl!	
VO_LOE_10_RESPONSE_ALT_read	Mittelflosse? Was treibst du denn hier?	
VO_LOE_10_START	Mrglmrglmrgl!	
VO_LOE_10_START_2	Wie meinen? Das ist aber sehr unverschämt.	
VO_LOE_10_TURN_2_GIANTFIN	MRRRGL! MRRRGLMRGL!	
VO_LOE_10_TURN1	Mrrrgl! Mrrglrrglmrgl!	
VO_LOE_10_WIN	Was für eine Schande. Mit einer besseren Erziehung wäre das gewiss nicht passiert.	
VO_LOE_12_NAZJAR_PEARL	Beeindruckend. Die Perle der Gezeiten übertrifft alle meine Erwartungen.	
VO_LOE_12_NAZJAR_TURN_1	Ich bin die Klinge von Azshara. Wer seid Ihr, dass Ihr glaubt, mich herausfordern zu können?	
VO_LOE_12_NAZJAR_TURN_1_FINLEY	Ich bin Sir Finley Mrrgglton. Das Vergnügen ist ganz meinerseits.	
VO_LOE_12_NAZJAR_TURN_3_FINLEY	Elise, wie ergeht es unseren werten Kollegen?	
VO_LOE_12_NAZJAR_TURN_5	Armeen der Tiefen, überkommt unsere Feinde wie eine Flut des Todes!	
VO_LOE_12_NAZJAR_TURN_5_FINLEY	Ist das nicht etwas extrem?	
VO_LOE_12_NAZJAR_TURN_7_FINLEY	Mrgggl! MRRGLMRRGL!	
VO_LOE_12_NAZJAR_TURN_7_FINLEY_2	Verzeihung, manchmal geht der Murloc in mir durch.	
VO_LOE_12_RESPONSE	Ich beherrsche die Macht der Perle!	
VO_LOE_12_START	Die Macht der Gezeiten wird Euch verschlingen!	
VO_LOE_12_WIN	Bravo! Die Perle gehört uns! Begleitet mich zur Halle der Forscher, dann fügen wir das Artefakt zusammen!	
VO_LOE_13_RESPONSE	GROARRR!	
VO_LOE_13_START_2	Grrr!	
VO_LOE_13_TURN_1	Der Stab ist verflucht. Er hat den Astralen durch unsere Schutzzauber hindurch beschworen und jetzt stiehlt er alles!	
VO_LOE_13_TURN_1_2	Nicht alles. Nur die wertvollen Stücke.	
VO_LOE_13_TURN_5	Oooh, ist das wirklich Arthas' Siegelring? Und sogar in hervorragendem Zustand.	
VO_LOE_13_TURN_5_2	Reno, Brann, versteckt die Artefakte!	
VO_LOE_13_TURN_9	Er erweckt eine Armee zum Leben! Elise, haltet ihn auf!	
VO_LOE_13_TURN_9_2	Tel'zaxus nalore! Der Stab ist einfach zu stark, aber ich kann ihn eine Zeit lang aufhalten.	
VO_LOE_13_WIN	Wir helfen mit den Ausstellungsstücken. Forscher, kümmert Euch um Rafaam!	
VO_LOE_14_RESPONSE	KLONK	
VO_LOE_14_START	Oh, das ist Lothars Rüstung! Dafür musste ich mich im Schwarzfels monatelang durch Drachendung wühlen.	
VO_LOE_14_TURN_13	Brann, er erweckt die Bibliotheksbestände zum Leben! Ich kümmere mich um die fliegenden Hämmer in der Lordaeron-Ausstellung.	
VO_LOE_14_TURN_5	Ich habe die belebten Schwerter in der östlichen Halle beseitigt. Elise, wem kann ich behilflich sein?	
VO_LOE_14_TURN_5_2	Geht zu Reno im Hauptlager! Er ist von Bummbots umzingelt.	
VO_LOE_14_TURN_9	Ihr seht alle sehr beschäftigt aus. Da nehm ich mir doch unterdessen diese hübsche Brosche.	
VO_LOE_14_WIN	Wir haben das Museum gesichert – jetzt geht es Rafaam an den Kragen!	
VO_LOE_15_RESPONSE	Was für wundervolle Karten!	
VO_LOE_15_SPARE	Forscher! Wir haben noch ein überzähliges Deck, versucht es damit!	
VO_LOE_16_BOOM_BOT	Davon haben wir noch tonnenweise. Macht ihm den Garaus!	
VO_LOE_16_CROWN	Die manifestierte Magie eines manischen Magiers. 	
VO_LOE_16_EYE	Komisch. Das war noch in meiner Hosentasche – hm, Ihr könnt es ausleihen.	
VO_LOE_16_FIRST_ITEM	Wir durchsuchen das Museum nach nützlichen Gegenständen. Meldet Euch, wenn Ihr etwas davon brauchen könnt!	
VO_LOE_16_GOBLET	Ich hasse Schlangen.	
VO_LOE_16_GREAVE	Ein Stück von Lothars Rüstung scheint Eure Streitereien unbeschadet überlebt zu haben.	
VO_LOE_16_LOCKET	Die Geister von Karazhan suchen dieses Medaillon heim.	
VO_LOE_16_PIPE	Fangt! Aber erzählt Brann bloß nicht davon, er liebt diese Pfeife!	
VO_LOE_16_RAFAAM_DEATH2	NEIN! Ich bin doch unbesiegbar!	
VO_LOE_16_SHARD	Das war in einer Kiste, die mit „NICHT ÖFFNEN“ beschriftet war. Äh ... viel Glück!	
VO_LOE_16_SPLINTER	Den habe ich im Geschmolzenen Kern gefunden. Majordomus hat ihn als Zahnstocher benutzt.	
VO_LOE_16_START_2	Der Stab lädt sich auf. Vorsicht!	
VO_LOE_16_TEAR	Ein heiliges Artefakt meines Volkes. Schnell! Trinkt!	
VO_LOE_16_TURN_2	Der Stab ist beinahe so weit! Macht Euch bereit!	
VO_LOE_16_TURN_2_2	HAHAHA! ÜBERWÄLTIGENDE MACHT!	
VO_LOE_16_TURN_2_3	Der Stab hat sich überladen! Das ist Euer Moment!	
VO_LOE_16_TURN_3	Ich bin unbesiegbar! Ihr habt keine Chance!	
VO_LOE_16_TURN_3_2	Der Stab lädt sich erneut auf. Bald haben wir eine weitere Gelegenheit.	
VO_LOE_16_TURN_4	Der Stab ist fast wieder bereit. Aufgepasst!	
VO_LOE_16_TURN_5	HAHAHA! ÜBERWÄLTIGENDE MACHT!	
VO_LOE_16_TURN_5_2	Sein Schild ist unten! Zeigt es ihm!	
VO_LOE_16_TURN_6	Der Schild ist wieder aktiv. Seid vorsichtig!	
VO_LOE_16_VIAL	Hier steht zwar „TRINK MICH“, aber da wir sie in Naxxramas gefunden haben, wollte es niemand probieren.	
VO_LOE_ARCHAEDAS_TURN_1_CARTOGRAPHER	Wenn er nicht damit beschäftigt wäre, Euch ein steiniges Grab zu bereiten.	
VO_LOE_GIANTFIN_TIDEHUNTER_2	Nein, Finley! Ihr wart schon damals etwas Besonderes.	
VO_LOE_NAZJAR_TURN_3_CARTOGRAPHER	Reno ist mit dem Schaft der Sonne zurückgekehrt und Brann ist auf dem Weg.	
VO_LOE_SCARVASH_TURN_6_CARTOGRAPHER	Bleibt bei der Sache, Brann!	
VO_LOE_ZINAAR_TURN_10_CARTOGRAPHER_2	Er steht nicht zum Verkauf.	
VO_LOE_ZINAAR_TURN_6_CARTOGRAPHER_2	Ja.	
VO_LOE_ZINAAR_TURN_6_CARTOGRAPHER_2_ALT	Ja.	
VO_LOE10_DEAD_MURLOCS	So viele Tote. Welch Verschwendung.	
VO_LOE10_NYAH_FINLEY	Absurd. Seid nicht kindisch.	
VO_LOE10_TIDEHUNTER	Ich wuchs als Gezeitenjäger auf, bevor Elise mich fand. Hätte das etwa mein Schicksal sein können?	
VO_LOE10_TURN_2_FINLEY	Brüder! Können wir unsere Konflikte denn nicht friedlich regeln?	
VO_LOE10_TURN_2_FINLEY_2	Das war wohl zu erwarten.	
VO_LOEA04_BRANN_TURN_1	Als ich das letzte Mal hier war, war Scarvash noch ein winziger Trogg. Nun ist er größer, dümmer und hässlicher.	
VO_LOEA04_BRANN_TURN_6	Faszinierend. Diese Mithrilrunen enthalten einen Wächtercode. Sie müssen aus der Zeit der Titanen stammen!	
VO_LOEA07_MINE_ALMOST_DONE	Bin gleich so weit! Hm, was macht dieser Knopf wohl?	
VO_LOEA07_MINE_ARCHAEDAS	BEI MAGNIS BART – IST DAS ARCHAEDAS HÖCHSTPERSÖNLICH?	
VO_LOEA07_MINE_BARREL_FORWARD	Volle Kraft voraus!	
VO_LOEA07_MINE_BOOM	Springbomben! Das wird ihnen eine Lehre sein!	
VO_LOEA07_MINE_BOOMZOOKA	BUMM! Haha! Ich lade noch mal nach!	
VO_LOEA07_MINE_DETONATE	Ihr wollt den Schacht sprengen? SEID IHR NOCH GANZ BEI TROST?	
VO_LOEA07_MINE_DYNAMITE	He, seid vorsichtig mit dem Zeug! Ihr habt gerade ein paar Schienen hochgehen lassen!	
VO_LOEA07_MINE_HUNKER_DOWN	In Deckung!	
VO_LOEA07_MINE_PARROT	Flieg, Ginny!	
VO_LOEA07_MINE_RAMMING	Haha! Aus dem Weg!	
VO_LOEA07_MINE_REPAIRS	Etwas Muskelmagenkaugummi und schon ist sie so gut wie neu!	
VO_LOEA07_MINE_SPIKED_DECOY	He! Ihr dummen Troggs! Kommt und holt mich!	
VO_LOEA08_TURN_1_BRANN	Ein Diener der uralten Titanen. Was er uns wohl für Geschichten erzählen könnte.	
VO_LOEA09_1_RESPONSE	Seid Ihr etwa der Nachtisch?	
VO_LOEA09_1_TURN1	Ihr wagt es, in die Verfallene Stadt einzudringen?	
VO_LOEA09_FINLEY_DEATH	Ich muss nur kurz Atem holen. Forscher, kümmert Euch derweil um diesen Naga!	
VO_LOEA09_HERO_POWER	Zeit fürs Abendessen! Heute gibt es Murlocsuppe!	
VO_LOEA09_HERO_POWER1	Grüße, Forscher. Ich befürchte, ich stecke hier etwas in der Klemme. Könntet Ihr einem Kollegen zur Hand gehen?	
VO_LOEA09_HERO_POWER2	Ich muss doch sagen, hier drinnen ist es furchtbar dunkel.	
VO_LOEA09_HERO_POWER3	Herrje. Es wird jetzt doch reichlich warm.	
VO_LOEA09_HERO_POWER4	Es wird hier nun doch etwas ungemütlich.	
VO_LOEA09_HERO_POWER5	Ähem, es ist wirklich ein bisschen heiß hier.	
VO_LOEA09_HERO_POWER6	Ich möchte nicht unhöflich sein, aber etwas Hilfe wäre angebracht.	
VO_LOEA09_QUOTE1	Danke sehr! Das war doch etwas knapp!	
VO_LOEA09_UNSTABLE	Zurück in den Topf mit dir!	
VO_LOEA09_WIN	Ich bin Euch zu Dank verpflichtet. Soll ich Euch nun zum letzten Teil führen?	
VO_LOEA10_1_MIDDLEFIN	Mittelflosse? Was treibst du denn hier?	
VO_LOEA15_1_LOSS_11	Euer Deck ist miserabel. Es wird Zeit, dass ich mein eigenes verwende.	
VO_LOEA15_1_LOW_HEALTH_10	Vielleicht war es ein Fehler, Euer Deck zu verwenden.	
VO_LOEA15_1_MAGMA_RAGER_09	Magmawüter? Warum sollte man diese Karte in ein Deck packen?	
VO_LOEA15_1_START_07	Ich mag Euer Deck. Ich denke, ich nehm es mir.	
VO_LOEA15_1_TURN1_08	Oooh, ja. Diese Hand ist unglaublich.	
VO_LOEA15_1_WIN_12	Euer Deck ist FANTASTISCH. Hahahahaha!	
VO_LOEA15_GOLDEN	Hat dieses Deck etwa NUR GOLDENE KARTEN? Eure Sammlung ist fast so gut wie meine!	
VO_LOEA16_1_CARD_04	Meine Sammlung umfasst Artefakte aus HUNDERTEN von Welten!	
VO_LOEA16_1_RESPONSE_03	Ja! JA!	
VO_LOEA16_1_START_01	Werdet Zeuge der GANZEN MACHT des Stabes!	
VO_LOEA16_1_TURN1_02	Ich bin unbesiegbar! Ich verfüge über die Macht der Titanen!	
VO_Maiden_Female_Titan_FinalMaidenEmoteResponse_01	Euer Verhalten wird nicht toleriert.	
VO_Maiden_Female_Titan_FinalMaidenEyeForAnEye_01	Der Gerechtigkeit wurde Genüge getan.	
VO_Maiden_Female_Titan_FinalMaidenHeroPower_01	Löst Euch von Euren verdorbenen Gedanken!	
VO_Maiden_Female_Titan_FinalMaidenHumility_01	Ja! Kniet nieder und Ihr sollt verschont werden!	
VO_Maiden_Female_Titan_FinalMaidenOpen_01	Ihr wagt es, eine Agentin der Titanen zu beschwören?	
VO_Maiden_Female_Titan_FinalMaidenTurn5_01	Wir sind die Ewigen. Ihr seid unwürdig!	
VO_Malchezaar_Male_Demon_Brawl_06	Ihr habt nicht wirklich geglaubt, dass Ihr gewinnen würdet.	
VO_Malchezaar_Male_Demon_EmoteParty_01	Malchezaar möchte mitfeiern!	
VO_Malchezaar_Male_Demon_FinalAltOpening_01	Dummköpfe!	
VO_Malchezaar_Male_Demon_FinalMalchezaarDeath_01	Nein! Nein! Nicht schon wieder!	
VO_Malchezaar_Male_Demon_FinalMalchezaarEmoteResponse_01	Ich werde Euch das Genick brechen!	
VO_Malchezaar_Male_Demon_FinalMalchezaarHeroPower_01	Ihr steht nicht nur vor Malchezaar allein, sondern vor den Legionen, die ich befehlige!	
VO_Malchezaar_Male_Demon_FinalMalchezaarJaraxxus_01	IHR! Das ist meine Einladung!	
VO_Malchezaar_Male_Demon_FinalMalchezaarMedivhSkin_01	Ihr habt Euch verkleidet? Hmm_... Das hätte ich auch gekonnt_...	
VO_Malchezaar_Male_Demon_FinalMalchezaarSacrificialPact_03	Hahaha! Ein wahrer Eredar ist gegen so etwas immun!	
VO_Malchezaar_Male_Demon_FinalMalchezaarTurn1_01	Der Magier ist mächtig, doch wie könnt IHR hoffen, solch überwältigender Macht zu widerstehen?	
VO_Malchezaar_Male_Demon_FinalMalchezaarTurn7_01	Ich höre die Musik! Die Medivas! Den Festlärm! Das wird meine Nacht!	
VO_Malchezaar_Male_Demon_FinalThirdSequence_01	Nach Karazhan zurückgerufen? Genau rechtzeitig zum Fest!	
VO_Malchezaar_Male_Demon_FinalThirdSequence_04	Aus dem Weg, Narr!	
VO_Malchezaar_Male_Demon_PrologueEmoteResponse_01	Dummkopf!	
VO_Malchezaar_Male_Demon_PrologueHeroPower_01	Alle Dimensionen, alle Realitäten stehen mir offen!	
VO_Malchezaar_Male_Demon_PrologueOpen_01	Wo ist meine Einladung?	
VO_Malchezaar_Male_Demon_PrologueTurn1_04	Ihr wagt es, mich nicht einzuladen? Ich bin ein Prinz der Eredar!	
VO_Malchezaar_Male_Demon_PrologueTurn11_02	Ihr habt Jaraxxus eingeladen? Diesen Schwächling?	
VO_Malchezaar_Male_Demon_PrologueWin_01	Ihr kommt mit mir!	
VO_Mediva_01_Female_Blood Elf_AranSpell_04	Oh... *Schlottert*	
VO_Mediva_01_Female_Blood Elf_ChessEmoteOops_06	Oh oh!	
VO_Mediva_01_Female_Blood Elf_PrologueTurn5_06	Medivas!	
VO_Mediva_02_Female_Draenei_JulianneDeadlyPoison_02	Wie tragisch!	
VO_Mediva_02_Female_Draenei_PrologueTurn5_05	Ja?	
VO_Mediva_03_Male_Night Elf_AranHeroPower_01	Der lässt nichts anbrennen!	
VO_Mediva_03_Male_Night Elf_CuratorBeasts_04	Hatschi, Baby!	
VO_Mediva_03_Male_Night Elf_PrologueTurn5_01	Ihr habt gerufen?	
VO_Medivas_Multiple_Multiple_CroneLionTigerBear_01	Oh weh!	
VO_Medivas_Multiple_Multiple_IllhoofWounded_01	Mmm, ich hab ja solche Angst.	
VO_Medivas_Multiple_Multiple_NetherspiteTurn1_01	Strahlen!	
VO_Medivh_Male_Human_EmoteGreetings_01	Was macht Ihr denn hier?	
VO_Medivh_Male_Human_EmoteOops_01	War das Euer Plan?	
VO_Medivh_Male_Human_EmoteSorry_01	Oh, das hat nicht funktioniert_...	
VO_Medivh_Male_Human_EmoteThanks_01	Ihr seid zu freundlich.	
VO_Medivh_Male_Human_EmoteThreaten_01	Ihr hattet niemals eine Chance!	
VO_Medivh_Male_Human_EmoteWellPlayed_01	Netter Versuch, Dämon!	
VO_Medivh_Male_Human_EmoteWow_01	Haha! Das war unglaublich!	
VO_Medivh_Male_Human_FinalMalchezaarTurn5_01	Ausgezeichnete Arbeit, Moroes – die Party ist bereits im vollen Gange!	
VO_Medivh_Male_Human_FinalMalchezaarWin_01	Gut gemacht! Kommt, es ist Zeit zu feiern!	
VO_Medivh_Male_Human_FinalMedivhMedivhSkin_01	Oh, wartet! Ihr seid ich_... das heißt, mein zukünftiges Ich, richtig? Na los, sagt schon, wie großartig war die Party? Spek-ta-ku-lär, oder?	
VO_Medivh_Male_Human_FinalThirdSequence_01	Ah, ein Gast! Bitte kümmert Euch um den Dämon. Ich werde als Gastgeber auf dem Fest verlangt!	
VO_Medivh_Male_Human_FinalThirdSequence_02	Euch sind die Karten ausgegangen? Benutzt einfach die Portale.	
VO_Medivh_Male_Human_FinalThirdSequence_03	Hier, nehmt meinen Stab, damit könnt Ihr die Portale kontrollieren. Passt nur auf, dass Ihr keine Kratzer reinmacht.	
VO_Medivh_Male_Human_PrologueDeath_02	Was? Unmöglich...	
VO_Medivh_Male_Human_PrologueHeroPower_01	Abgesehen von dieser Feier!	
VO_Medivh_Male_Human_PrologueOpen_01	Ihr schon wieder?	
VO_Medivh_Male_Human_PrologueTurn1_02	Nach Eurem letzten Auftritt? Wir sind immer noch dabei, das Loch im Dach zu reparieren!	
VO_Medivh_Male_Human_PrologueTurn11_01	Habt Ihr ihn einmal Karaoke singen gehört? Einfach sensationell!	
VO_Medivh_Male_Human_PrologueTurn3_02	Moroes, schaut nach dem Schachspiel. Die richtigen Gäste werden jeden Augenblick eintreffen.	
VO_Medivh_Male_Human_PrologueTurn9_01	Ballons! Moroes, wir haben die Ballons vergessen!	
VO_Medivh_Male_Human_PrologueWin_01	Zurück, wo Ihr herkamt, Dämon!	
VO_Medivh_Male_Human_Wing0Intro_01	Wir haben das Tafelsilber zum Leben erweckt, Schauspiele geprobt und die Menagerie vorbereitet. Dieses Fest wird in die Geschichte eingehen!	
VO_Medivh_Male_Human_Wing4Win_01	Los, kommt, Abenteurer! Mischt Euch unter die Gäste!	
VO_Mirror_Male_Mirror_MirrorDeath_01	Hey! Ihr habt geschummelt! Ich fordere Revanche!	
VO_Mirror_Male_Mirror_MirrorEmoteResponse_01	Pff... Schaut Euch doch erst mal im Spiegel an!	
VO_Mirror_Male_Mirror_MirrorFirstCard_01	So etwas habt Ihr in Eurem Deck!?	
VO_Mirror_Male_Mirror_MirrorMedivhSkin_01	Oh, Medivh, Sir! Ihr habt Euch ja wirklich in Schale geworfen heute Ab... Hey! Ihr seid gar nicht Medivh!	
VO_Mirror_Male_Mirror_MirrorMirrorImage_01	Hey, das ist meine Lieblingskarte! Welche ist Eure? Magmawüter?	
VO_Mirror_Male_Mirror_MirrorOpen_02	WASGEHTAAAAAB?	
VO_Mirror_Male_Mirror_MirrorTurn1_01	Wow, seid Ihr hässlich!	
VO_Mirror_Male_Mirror_MirrorTurn3_01	Spieglein, Spieglein an der Wand, wer ist der Schönste im ganzen Land?	
VO_Mirror_Male_Mirror_MirrorTurn3_03	Ihr jedenfalls nicht, Ihr Vogelscheuche!	
VO_Mirror_Male_Mirror_MirrorTurn5_02	Nefarius? Ihr meint wohl eher Speck-farius, ha hah ha!	
VO_Mirror_Male_Mirror_MirrorWellPlayedResponse_01	Ich wünschte, ich könnte das Gleiche von Euch sagen! Hah, der hat gesessen!	
VO_Moroes_Male_Human_AranTurn1_01	*Seufzt* Darf ich vorstellen: Aran, der unfreundliche Geist.	
VO_Moroes_Male_Human_AranTurn9_04	Die Drachen haben das Buffet bis auf den letzten Krümel verschlungen. Jetzt haben sie es auf die Murlocs abgesehen!	
VO_Moroes_Male_Human_AranWin_01	Das Portal ist im nächsten Raum! Wir kommen gerade rechtzeitig!	
VO_Moroes_Male_Human_ChessForfeit_02	Ihr habt keine Figuren mehr. Ihr habt verloren.	
VO_Moroes_Male_Human_ChessTurn1_03	Figuren greifen automatisch am Ende Eures Zuges an.	
VO_Moroes_Male_Human_ChessTurn3_01	Wenn sich eine Figur zwischen zwei Feinden befindet, schlägt sie beide!	
VO_Moroes_Male_Human_ChessTurn5_01	Die richtige Stellung ist der Schlüssel zum Erfolg. Versucht, möglichst oft Doppelangriffe auszuführen!	
VO_Moroes_Male_Human_ChessTurn7_01	Die anderen Gäste warten schon draußen! Wir sind gleich im Theater, aber wir müssen uns beeilen!	
VO_Moroes_Male_Human_ChessTurn7_02	Ihr habt nicht mehr viele Figuren. Wenn Ihr keine mehr übrig habt, verliert Ihr.	
VO_Moroes_Male_Human_ChessWin_01	Ausgezeichnet! Weiter zum Theater! 	
VO_Moroes_Male_Human_CroneTurn5_02	Majordomus Exekutus wartet unten. Soll ich ihm sagen, dass er zu früh ist?	
VO_Moroes_Male_Human_CroneWin_01	Ausgezeichnet! Endlich können wir den Zauberer befreien!	
VO_Moroes_Male_Human_CuratorTurn3_01	Der Kurator hat eine Fehlfunktion! Ihr müsst ihn aufhalten, bevor er sämtliche Exponate freilässt!	
VO_Moroes_Male_Human_CuratorWin_01	Ah, diese Schraube war locker_... So, jetzt müsste er wieder wie neu sein.	
VO_Moroes_Male_Human_EndWing1_01	Ausgezeichnet! Diese Treppe führt direkt zum Theater. Ich bin mir sicher, Barnes wird uns schnell durchlassen. 	
VO_Moroes_Male_Human_FinalAltTurn5_01	Hm_... So viele Portale. Ich frage mich, wo dieses wohl hinführt.	
VO_Moroes_Male_Human_FinalMaidenTurn1_01	Oh, tut mir leid. Kümmert Euch um sie, ich versuche in der Zwischenzeit, den richtigen Schalter zu finden.	
VO_Moroes_Male_Human_FinalMaidenTurn7_03	Oh, das ist die Tentakelwelt. Um die machen wir lieber einen großen Bogen.	
VO_Moroes_Male_Human_FinalNazraTurn7_02	Ihr müsst die Orcfrau zurückdrängen, damit wir ein anderes Portal öffnen können.	
VO_Moroes_Male_Human_FinalSecondSequence_01	Hervorragend! Dann schauen wir doch einmal, ob dieses Portal funktioniert_...	
VO_Moroes_Male_Human_FInalStartSequence_01	Hmm ... Mal sehen. Vielleicht dieses hier?	
VO_Moroes_Male_Human_FinalThirdSequence_01	Das muss das richtige Portal sein!	
VO_Moroes_Male_Human_FinalTurn1_02	Ups! Falsches Portal. Wehrt die Orcfrau ab, damit ich es noch einmal versuchen kann.	
VO_Moroes_Male_Human_IllhoofKilrekResponse_01	Was versuchen sie da nur zu beschwören?	
VO_Moroes_Male_Human_JulianneTurn5_01	Barnes, lasst uns vorbei! Wir müssen schleunigst Medivh befreien, sonst ist das Fest ruiniert!	
VO_Moroes_Male_Human_JulianneTurn9_02	Illidan ist hier! Ihr wisst nicht, was uns erwartet!	
VO_Moroes_Male_Human_MedivhSkinResponse_01	Ihr habt Euch als Medivh verkleidet? Ich muss zugeben, die Ähnlichkeit ist verblüffend.	
VO_Moroes_Male_Human_MirrorTurn3_01	Hm_...	
VO_Moroes_Male_Human_MirrorTurn5_01	Lord Nefarius wird bald ankommen. Ich wage nicht, daran zu denken, wie er reagieren wird.	
VO_Moroes_Male_Human_MirrorWin_02	Ausgezeichnet! Zum Theater geht es diese Treppen hoch!	
VO_Moroes_Male_Human_NetherspiteTurn1_01	Diese Strahlen stärken den Drachen. Blockiert sie mit Dienern.	
VO_Moroes_Male_Human_NetherspiteTurn5_01	Sagt uns einfach, in welchem Portal Medivh steckt!	
VO_Moroes_Male_Human_NetherspiteTurn7_01	Wir brauchen diese Portale! Die Gäste fangen bereits an, Folianten in das Manabecken zu werfen!	
VO_Moroes_Male_Human_NetherspiteWin_01	Gut gemacht! Wenn ich mich nur erinnern könnte, wie dieses Gerät funktioniert_...	
VO_Moroes_Male_Human_NightbaneTurn3_01	Kurator, wir müssen Medivh retten!	
VO_Moroes_Male_Human_NightbaneTurn7_01	Die Forscherliga ist hier. RENO, LEGT SOFORT DAS TAFELSILBER ZURÜCK!	
VO_Moroes_Male_Human_PrologueTurn11_01	*Räuspern* Und er hat nicht die Bibliothek in Brand gesetzt_…	
VO_Moroes_Male_Human_PrologueTurn5_03	Sir, die Medivas sind bereit für ihren Auftritt. Barnes probt gerade mit ihnen.	
VO_Moroes_Male_Human_PrologueTurn7_01	Habt Ihr schon einen Blick in die Empfangshalle geworfen? Die Schlachtzugsbosse prügeln sich um Einladungen.	
VO_Moroes_Male_Human_PrologueTurn9_02	Sir, Murlocs haben Angst vor Ballons. Erinnert Ihr Euch an letzte Woche?	
VO_Moroes_Male_Human_PrologueWin_02	Das ist nicht gut. Das ist gar nicht gut!	
VO_Moroes_Male_Human_SilverwareResponse_01	Oh nein! Das war ein Erbstück.	
VO_Moroes_Male_Human_SilverwareTurn3_02	Das Tafelsilber hat sich gegen uns verschworen! Wir sind umzingelt!	
VO_Moroes_Male_Human_SilverwareWin_01	*Seufzt* Schöne Bescherung!	
VO_Moroes_Male_Human_Wing1Intro_02	Ich bin Moroes, der Turmwärter von Karazhan. Ich brauche Eure Hilfe. Medivh wurde entführt! Nur mit den Portalen in der Turmspitze können wir ihn und das Fest retten.	
VO_Moroes_Male_Human_Wing1Win_01	Sehr gut! Wenn wir so weiter machen, schaffen wir es vielleicht doch noch rechtzeitig zur Turmspitze!	
VO_Moroes_Male_Human_Wing2Win_01	Vorwärts! Hier oben bewacht der Kurator die Menagerie. Ich hoffe, dass er keine Fehlfunktion hat_...	
VO_Moroes_Male_Human_Wing3Open_02	Der Kurator bewacht die Menagerie, eine Sammlung der exotischsten Kreaturen Azeroths. Darüber befinden sich die Gemächer des Meisters und das Portal, mit dem wir Medivh retten können!	
VO_Moroes_Male_Human_Wing3Win_02	Wir sind fast an der Spitze! Wir müssen uns beeilen – bevor auf der Feier unten die Stimmung kippt!	
VO_Moroes_Male_Human_Wing4Intro_01	Endlich! Die Turmspitze! Findet das richtige Portal und bringt Medivh zurück!	
VO_Moroes_Male_Human_Wing4Win_01	Ihr habt es geschafft! Kaum zu glauben, dass das Fest rechtzeitig beginnen konnte. Hättet Ihr nächste Woche Zeit? Medivh feiert seinen Geburtstag und_... ich könnte ein wenig Verstärkung gebrauchen.	
VO_Moroes_Male_Human_WolfClaws_03	Das wage ich ernsthaft zu bezweifeln.	
VO_NAX1_01_CARD_02	Nur einmal kosten ...	
VO_NAX1_01_DEATH_05	Ach, warum nur ...	
VO_NAX1_01_EMOTE_04	Es spricht!	
VO_NAX1_01_HP_03	Kommt näher, Ihr kleinen Leckerbissen.	
VO_NAX1_01_START_01	Willkommen in meinem Reich.	
VO_NAX10_01_DEATH_LINE_03	Was... sein geschehen... mit Flick... aaaahrr...	
VO_NAX10_01_EMOTE1_04	Jetzt spielen?	
VO_NAX10_01_EMOTE2_05	Ja! Spielen! Spielen!	
VO_NAX10_01_HP_02	Nicht mehr spielen?	
VO_NAX10_01_START_01	Flickwerk spielen möchte!	
VO_NAX11_01_CARD_03	Schleim.	
VO_NAX11_01_DEATH_05	*Uh uh ahoh gor grrrlrrlrrlaaahhh*	
VO_NAX11_01_EMOTE_04	Nicht reden.	
VO_NAX11_01_HP_02	Gestank.	
VO_NAX11_01_START_01	Fleisch.	
VO_NAX12_01_CARD_01	*Brüll*	
VO_NAX12_01_DEATH_01	*Wimmer*	
VO_NAX12_01_EMOTE_01	*Knurr*	
VO_NAX12_01_EMOTE_02	*Grrr*	
VO_NAX12_01_EMOTE_03	*Heul*	
VO_NAX12_01_HP_01	*Brüll ZUBEISS*	
VO_NAX12_01_START_01	*Knurr*	
VO_NAX13_01_DEATH_LINE_03	Ich ... danke Euch ...	
VO_NAX13_01_EMOTE_04	Töten ...	
VO_NAX13_01_HP_02	Ihr werdet jetzt ... sterben!	
VO_NAX13_01_START_01	Ich ... muss ... gehorchen!	
VO_NAX14_01_CARD_01	*rrrrrAAAHH*	
VO_NAX14_01_DEATH_01	*roooarrr...*	
VO_NAX14_01_EMOTE_01	*rrrr Rrahhh!*	
VO_NAX14_01_EMOTE_02	*grraaaaah*	
VO_NAX14_01_EMOTE_03	*rooooaaar*	
VO_NAX14_01_HP_01	*roooarrr*	
VO_NAX14_01_START_01	*ROOOARRR*	
VO_NAX15_01_BIGGLES_32	Nein! Ich verfluche Euch, Eindringling!	
VO_NAX15_01_DEATH_LINE_08	Das ist nicht das Ende! ... Wir sehen uns im heroischen Modus.	
VO_NAX15_01_DEATH_LINE2_09	Neeeeeeeeeeeeeeeiin!	
VO_NAX15_01_EMOTE_HELLO_26	Begrüßt Ihr oft diejenigen, die Euch töten wollen?	
VO_NAX15_01_EMOTE_OOPS_29	In der Tat.	
VO_NAX15_01_EMOTE_SORRY_28	Schon in Ordnung, Eindringling. Jeder macht mal einen Fehler.	
VO_NAX15_01_EMOTE_THANKS_27	Keine ... Ursache?	
VO_NAX15_01_EMOTE_THREATEN_30	Oh, ich hab ja solche Angst!	
VO_NAX15_01_EMOTE_WP_25	Ha, selbstverständlich habe ich gut gespielt. Ich bin schließlich Kel'Thuzad.	
VO_NAX15_01_HP_07	Ich werde das Blut in Euren Adern gefrieren lassen!	
VO_NAX15_01_HP2_05	Eure Seele gehört jetzt mir!	
VO_NAX15_01_HP3_06	Es gibt kein Entrinnen!	
VO_NAX15_01_HURRY_31	Meine Geduld währt nicht ewig.	
VO_NAX15_01_PHASE2_10	Narr! Eure Macht reicht nicht aus.	
VO_NAX15_01_PHASE2_ALT_11	Nein! Euer Zug ist vorüber. Jetzt bin ICH dran.	
VO_NAX15_01_RESPOND_ANDUIN_24	Wie naiv. Habt Ihr etwa schon vergessen, was mit Uther geschehen ist?	
VO_NAX15_01_RESPOND_GARROSH_15	Wirklich? Na dann, Sieg für mich, Tod für Euch.	
VO_NAX15_01_RESPOND_GARROSH_ALT_16	Ist das eine Fangfrage? Sieg für mich, Tod für Euch.	
VO_NAX15_01_RESPOND_GULDAN_22	Dass Ihr Euch da mal nicht irrt!	
VO_NAX15_01_RESPOND_JAINA_23	Nein, mit Sicherheit nicht. IHR seid frisch-fröhlich in MEINE schwebende Nekropole hereinspaziert.	
VO_NAX15_01_RESPOND_MALFURION_ALT_21	Die Wildnis? Was macht Ihr dann in Naxxramas?	
VO_NAX15_01_RESPOND_REXXAR_19	Wie Ihr wollt.	
VO_NAX15_01_RESPOND_THRALL_17	Eure Drohungen lassen mich kalt.	
VO_NAX15_01_RESPOND_UTHER_14	... und ich mit gigantischen Dienern und vernichtenden Zaubern. Viel Glück!	
VO_NAX15_01_RESPOND_VALEERA_18	Wie ... Ihr meint.	
VO_NAX15_01_START_13	Endlich lernen wir uns kennen.	
VO_NAX15_01_SUMMON_ADDS_12	Ich schenke Euch die Freiheit, Untertanen.	
VO_NAX2_01_CARD_02	Tötet sie im Namen des Meisters!	
VO_NAX2_01_CUSTOM_03	Ihr habt versagt!	
VO_NAX2_01_DEATH_LINE_05	Mein Meister wird mich rächen!	
VO_NAX2_01_EMOTE_06	Hahahaha!	
VO_NAX2_01_HP_04	Kniet nieder, Wurm!	
VO_NAX2_01_START_01	Meine Akolythen gehorchen mir bedingungslos!	
VO_NAX3_01_CARD_01	*Grghhghgh*	
VO_NAX3_01_DEATH_01	*Kssssss*	
VO_NAX3_01_EMOTE_01	*Kssssss*	
VO_NAX3_01_EMOTE_02	*Kssssss*	
VO_NAX3_01_EMOTE_03	*Kssssss*	
VO_NAX3_01_EMOTE_04	*Kssssss*	
VO_NAX3_01_EMOTE_05	*Kssssss*	
VO_NAX3_01_HP_01	*Kssssss*	
VO_NAX3_01_START_01	*Klicken*	
VO_NAX4_01_CARD_03	Sterbt!	
VO_NAX4_01_DEATH_LINE_04	Ich werde dem Meister über den Tod hinaus dienen!	
VO_NAX4_01_EMOTE_06	Sterbt, Eindringling!	
VO_NAX4_01_HP_02	Erhebt euch, Soldaten! Erhebt euch und kämpft erneut!	
VO_NAX4_01_START_01	Noch eine Seele für meine Sammlung.	
VO_NAX5_01_CARD_03	Das wird Euch umhauen!	
VO_NAX5_01_DEATH_LINE_04	Ich hätte mich doch duschen sollen ...	
VO_NAX5_01_EMOTE_05	Ich habe keine Zeit für solchen Unsinn.	
VO_NAX5_01_HP_02	Tanzt, Ihr Narren!	
VO_NAX5_01_START_01	Ihr denkt, Ihr seid in Sicherheit?	
VO_NAX6_01_CARD_03	Das Ende naht.	
VO_NAX6_01_DEATH_LINE_04	*Rruuuhhhh*	
VO_NAX6_01_EMOTE_05	Ihr verschwendet Eure Worte.	
VO_NAX6_01_HP_02	Ihr gehört mir ...	
VO_NAX6_01_START_01	Ihr entgeht mir nicht ...	
VO_NAX7_01_CARD_03	Ihr hättet daheim bleiben sollen!	
VO_NAX7_01_DEATH_LINE_04	Ein ehrenhafter ... Tod.	
VO_NAX7_01_EMOTE_05	Haha! Ich fange gerade erst an!	
VO_NAX7_01_HP_02	Yieea!	
VO_NAX7_01_START_01	Nein ... nein! Meine Schüler! Lasst sie gehen!	
VO_NAX8_01_CARD_02	Tötet ruhig meine Diener ... Ihre Seelen werden Euch heimsuchen.	
VO_NAX8_01_CUSTOM_03	Hahaha! Narr! Ich bin der Seelenernter!	
VO_NAX8_01_CUSTOM2_04	Die Toten kehren zurück!	
VO_NAX8_01_DEATH_LINE_05	Das ... ist ... mein ... Ende.	
VO_NAX8_01_EMOTE1_06	Ihr Narren habt Euren eigenen Untergang heraufbeschworen.	
VO_NAX8_01_EMOTE2_07	Voller Leichtsinn habt Ihr Euch mit Kräften angelegt, die weit über Euren Verstand hinausgehen.	
VO_NAX8_01_EMOTE3_08	Tapfer seid Ihr in das Reich des Seelenernters vorgedrungen.	
VO_NAX8_01_EMOTE4_09	Doch jetzt gibt es nur noch einen Ausweg ...	
VO_NAX8_01_EMOTE5_10	... im Optionsmenü „Aufgeben“ zu wählen.	
VO_NAX8_01_START_01	Meine Diener sterben nie wirklich.	
VO_NAX9_01_CUSTOM_02	Genug mit dem Geschwätz. Lasst sie nur kommen.	
VO_NAX9_01_DEATH_LINE_03	Nein! Ich brauche mehr Zeit!	
VO_NAX9_01_EMOTE_04	Ihr sucht den Tod?	
VO_NAX9_01_START_01	Wir werden Eure Knochen zu Staub zermalmen.	
VO_NAX9_02_CUSTOM_01	Eindringling! Kehrt um, solange Ihr noch könnt!	
VO_NAX9_03_CUSTOM_01	Kommt, Zeliek, lasst uns unseren Spaß haben mit ihnen!	
VO_NAX9_04_CUSTOM_01	Zeigt, was Ihr draufhabt, Wicht!	
VO_Nazra_Female_Orc_FinalNazraChogall_02	Der Schattenhammerklan? Hier?	
VO_Nazra_Female_Orc_FinalNazraDeath_01	Für die Horde...	
VO_Nazra_Female_Orc_FinalNazraEmoteResponse_01	Nazra wird Euch zerschmettern!	
VO_Nazra_Female_Orc_FinalNazraGrom_01	Grommash?! Wir haben uns eine Ewigkeit nicht gesehen!	
VO_Nazra_Female_Orc_FinalNazraHeroPower_01	Nazra wird diese mickrige Welt versklaven!	
VO_Nazra_Female_Orc_FInalStartSequence_01	Kniet nieder vor der Horde!	
VO_NEFARIAN_ATRAMEDES_DEATH_76	Ihr habt einen BLINDEN Drachen getötet. Ihr solltet Euch schämen.	
VO_NEFARIAN_BARON_GEDDON_DEAD_40	Wir sind nah. Ja. Ja!	
VO_NEFARIAN_CHROMAGGUS_DEAD_63	Tatsächlich war Chromaggus mein schwächster Diener. Wart Ihr etwa stolz auf Eure Leistung?	
VO_NEFARIAN_CHROMAGGUS1_59	Ich habe ihm zwei Köpfe gegeben, damit er auch doppelt so gut zubeißen kann!	
VO_NEFARIAN_CHROMAGGUS2_60	In ihm habe ich die Macht aller Drachenschwärme verschmolzen. Er ist perfekt!	
VO_NEFARIAN_CHROMAGGUS3_61	Gut gemacht, Chromaggus. Guter Junge.	
VO_NEFARIAN_CHROMAGGUS4_62	Wird Eure Hand etwas lahm? Muahaha! Braver Hund.	
VO_NEFARIAN_COREN_DEAD_28	Der Grimmige Säufer ... So grimmig war er gar nicht.	
VO_NEFARIAN_DRAKKISATH_DEAD_50	So langsam geht Ihr mir auf die Nerven.	
VO_NEFARIAN_DRAKKISATH_RESPOND_48	Ja, Drakkisath. Abenteurer – Ihr seid noch immer auf der falschen Seite des Berges.	
VO_NEFARIAN_DRAKKISATH1_49	Spielt lieber ein paar gewertete Spiele. Der Abenteuermodus scheint Euch nicht so zu liegen.	
VO_NEFARIAN_GARR_DEAD1_38	Ihr solltet ein Stück von Garr nehmen und damit Euer Badezimmer fliesen. Ragnaros wird das bestimmt sehr mögen.	
VO_NEFARIAN_GARR2_35	Passt doch bitte auf diese nervigen Kieselsteine auf!	
VO_NEFARIAN_GARR3_36	Seht zu, dass Ihr nicht explodiert. Ihr müsst noch einen Elementarlord vernichten.	
VO_NEFARIAN_GARR4_37	Wisst Ihr, ich schaue Euch gerne bei der Arbeit zu.	
VO_NEFARIAN_GRIMSTONE_DEAD1_30	Nur weiter so und dieser Berg wird Ragnaros bald los sein.	
VO_NEFARIAN_HEROIC_BLOCK_77	Nicht im heroischen Modus!	
VO_NEFARIAN_MALORIAK_DEATH_PT1_72	Glückwunsch! Was für eine herausragende Leistung!	
VO_NEFARIAN_MALORIAK_DEATH_PT2_73	Ich werde mir in Erinnerung an diesen Moment einen neuen Namen für Euch ausdenken.	
VO_NEFARIAN_MALORIAK_DEATH_PT3_74	„Schlächter von dummen, inkompetenten und enttäuschenden Lakaien“. Ja, das passt.	
VO_NEFARIAN_MALORIAK_TURN2_71	Maloriak, versucht doch bitte nicht zu verlieren.	
VO_NEFARIAN_NEF_MISSION_66	IHR MOGELT DOCH! DAS WERDE ICH NICHT TOLERIEREN!	
VO_NEFARIAN_NEF2_65	Nein! NEIN! ICH WERDE EUCH VERNICHTEN!	
VO_NEFARIAN_OMNOTRON_DEAD_69	Da habt Ihr mir eine Menge Reparaturkosten erspart. Danke.	
VO_NEFARIAN_OMOKK_DEAD_46	Das ist absolut sinnlos!	
VO_NEFARIAN_OMOKK1_44	Warum seid Ihr noch hier? Ragnaros ist tot. Ihr solltet mit Euren Freunden irgendwo feiern gehen.	
VO_NEFARIAN_OMOKK2_45	Ich bin verwirrt. Hier oben gibt es keine Ragnarosse. Eure Quest ist abgeschlossen. Geht nach Hause!	
VO_NEFARIAN_RAZORGORE_DEAD_55	Diese Eier waren für großartige Experimente gedacht!	
VO_NEFARIAN_REND_DEAD_53	Na gut, Sterblicher. Ihr legt Euch mit dem falschen Drachen an.	
VO_NEFARIAN_REND1_52	Sogar dieser Orc versteht, dass Ihr etwas falsch macht.	
VO_NEFARIAN_THAURISSAN_DEAD_32	Ihr hättet den anderen Zwerg töten sollen! Lasst keinen am Leben!	
VO_NEFARIAN_THAURISSAN_DEAD2_33	Ihr habt es tatsächlich geschafft, beide Zwerge zu töten? Nicht schlecht, Abenteurer.	
VO_NEFARIAN_VAEL_DEAD_57	Ha! Ihr habt einen der Guten getötet! Macht Euch das etwa traurig?	
VO_Netherspite_Male_Dragon_NetherspiteAngryChicken_01	Ihr schon wieder! Was habt Ihr immer in meinen Portalen zu suchen?	
VO_Netherspite_Male_Dragon_NetherspiteDeath_01	Meine Forschung_...	
VO_Netherspite_Male_Dragon_NetherspiteEmoteResponse_01	Ihr wagt es, einen Drachen in seinem eigenen Labor herauszufordern?	
VO_Netherspite_Male_Dragon_NetherspiteEmpowerment_01	So viele Welten! So viel zu entdecken!	
VO_Netherspite_Male_Dragon_NetherspiteOpen_01	Wer stört mich bei meiner Arbeit?	
VO_Netherspite_Male_Dragon_NetherspiteShadowBreath_01	Verschwindet!	
VO_Netherspite_Male_Dragon_NetherspiteTurn12_01	Hmm_… Wenn 12 Murlocs das rote Portal um 16 Uhr verlassen und C’Thun um 17 Uhr erscheint, dann_…	
VO_Netherspite_Male_Dragon_NetherspiteTurn3_02	Meine Versuchsanordnung! Lasst die Finger davon!	
VO_Netherspite_Male_Dragon_NetherspiteTurn5_01	Hört auf, an den Portalen herumzuspielen! Die Fluxmodulationen sind genau eingestellt!	
VO_Netherspite_Male_Dragon_NetherspiteTurn7_01	Das Fest ist in vollem Gange. Mischt Euch lieber unter die Gäste und lasst meine Portale in Ruhe!	
VO_Netherspite_Male_Dragon_NetherspiteUnstablePortal_01	Interessant. Anzeichen fundamentaler Instabilität.	
VO_Netherspite_Male_Dragon_NetherspiteUnstablePortal_02	Interessant. Anzeichen fundamentaler Instabilität.	
VO_Nightbane_Roar	*GROAR*	
VO_RAGNAROS_GRIMSTONE_DEAD2_66	DICH WERDE ICH LÄUTERN, DU RÄUDIGER WELPLING!	
VO_RAGNAROS_NEF1_71	ABENTEURER. ES SIEHT AUS, ALS KÖNNTET IHR HILFE GEBRAUCHEN.	
VO_RAGNAROS_NEF3_72	DIE RACHE WIRD MEIN SEIN! DAS FEUER WIRD DICH LÄUTERN!	
VO_RAGNAROS_NEF4_73	ICH SENDE MEINE DIENER AUS, DICH ZU ZERSTÖREN, PECHSCHWINGE.	
VO_RAGNAROS_NEF5_74	VERBRENNT DIESEN ÜBERHEBLICHEN DRACHEN ZU ASCHE!	
VO_RAGNAROS_NEF6_75	MIT BESTEN GRÜSSEN AUS DEN FEUERLANDEN!	
VO_RAGNAROS_NEF7_76	DIE FLAMMEN DES FEUERFÜRSTEN KANNST DU NICHT ERSTICKEN!	
VO_RAGNAROS_NEF8_77	ICH WERDE MICH RÄCHEN, DRACHE!	
VO_SilverwareGolem_Male_SilverwareGolem_SilverwareDeath_02	Ich stehe vor einem Scherbenhaufen_...	
VO_SilverwareGolem_Male_SilverwareGolem_SilverwareEmoteResponse_01	Willkommen zum Polterabend!	
VO_SilverwareGolem_Male_SilverwareGolem_SilverwareForkedLightning_01	Ihr wollt Gabeln? Da habt Ihr Gabeln!	
VO_SilverwareGolem_Male_SilverwareGolem_SilverwareHeroPower_01	Es ist angerichtet!	
VO_SilverwareGolem_Male_SilverwareGolem_SilverwareKnifeJuggler_01	Oooh, ein Messerwerfer!	
VO_SilverwareGolem_Male_SilverwareGolem_SilverwareOpen_01	Darf ich zum Tanz bitten?	
VO_SilverwareGolem_Male_SilverwareGolem_SilverwarePlateTossing_01	Da, fangt! Und den hier! Und den auch! Ha hah ha! Scherben bringen Glück!	
VO_TB_MEDIVA1_001	Feuer!	
VO_TB_MEDIVA1_002	Vorsicht!	
VO_TB_MEDIVA1_003	Oh Tito!	
VO_TB_MEDIVA1_004	Gesundheit.	
VO_TB_MEDIVA1_005	Tierisch!	
VO_TB_MEDIVA1_006	Wie knuddelig!	
VO_TB_MEDIVA1_007	Nein! Kein Gift!	
VO_TB_MEDIVA1_008	In Farbe!	
VO_TB_MEDIVA1_009	Ihr habt geläutet?	
VO_TB_MEDIVA2_001	Heiß!	
VO_TB_MEDIVA2_002	Schaurig!	
VO_TB_MEDIVA2_003	Ooh, kalt.	
VO_TB_MEDIVA2_004	Oh nein! Eine Falle!	
VO_TB_MEDIVA2_005	Ich kann nicht hinsehen!	
VO_TB_MEDIVA2_006	Wie niedlich.	
VO_TB_MEDIVA2_007	Ich liebe Wichtel.	
VO_TB_MEDIVA2_008	Toll!	
VO_TB_MEDIVA2_009	Ha-ha-hatschi!	
VO_TB_MEDIVA2_010	Habt Ihr geläutet?	
VO_TB_MEDIVA3_001	Heiß!	
VO_TB_MEDIVA3_002	Eisekalt, Baby!	
VO_TB_MEDIVA3_003	Schaurige Finsternis!	
VO_TB_MEDIVA3_004	Eine Falle!	
VO_TB_MEDIVA3_005	Wilde Tiere!	
VO_TB_MEDIVA3_006	Yeah, lasst die Wichtel los!	
VO_TB_MEDIVA3_007	Wie schrecklich.	
VO_TB_MEDIVA3_008	Wohl bekomm's_...	
VO_TB_MEDIVA3_009	Hier sind die Medivas!	
VO_TB_MEDIVA3_010	Ja!	
VO_TIRION_INTRO_03	Welcher unserer tapferen Ritter wird heute zum Champion ernannt?	
VO_WhiteKing_Male_ChessPiece_ChessDeath_01	Schachmatt_...	
VO_WhiteKing_Male_ChessPiece_ChessEmoteGreetings_01	Lust auf eine Partie?	
VO_WhiteKing_Male_ChessPiece_ChessEmoteOops_01	Oh, ein grober Fehler.	
VO_WhiteKing_Male_ChessPiece_ChessEmoteSorry_01	Eine unglückliche Entwicklung.	
VO_WhiteKing_Male_ChessPiece_ChessEmoteThanks_01	Sehr freundlich.	
VO_WhiteKing_Male_ChessPiece_ChessEmoteThinking_01	Hmm, Turm auf A3_...	
VO_WhiteKing_Male_ChessPiece_ChessEmoteThinking_02	Springer auf F6_...	
VO_WhiteKing_Male_ChessPiece_ChessEmoteThinking_03	Dame auf E5_... Äh, nein, lieber doch nicht_...	
VO_WhiteKing_Male_ChessPiece_ChessEmoteThreaten_01	Ich sehe ein Matt in 4 Zügen.	
VO_WhiteKing_Male_ChessPiece_ChessEmoteWellPlayed_01	Schachmatt.	
VO_WhiteKing_Male_ChessPiece_ChessEmoteWow_01	Ah, ein brillanter Zug!	
VO_WhiteKing_Male_ChessPiece_ChessOpen_02	En garde!	
VOX_Nightbane_Start_01	Groar!	
