TAG	TEXT	COMMENT
ChromaggusBoss_Death_1	¡Roaaaaarr!	
ChromaggusBoss_EmoteResponse_1	*Gruñido*	
ChromaggusBoss_Start_1	¡Grrr!	
LOE_07_MINE_CART_EMOTES	CLANK	
OnyxiaBoss_Death_1	¡Roaaaaarr!	
OnyxiaBoss_EmoteResponse_1	*Gruñido*	
OnyxiaBoss_Start_1	¡Grrr!	
POPUP_FROST_BRAWL	¡Fatiga! Quien tenga más salud al final del próximo turno ganará la partida.	
POPUP_FROST_BRAWL_ARMOR	¡En esta pelea no vale esconderse detrás de la armadura!	
VO_Ahune_Male_Elemental_Brawl_01	¡SÍ! ¡APLASTEMOS A RAGNAROS!	
VO_Ahune_Male_Elemental_Brawl_02	¿QUIÉN TIENE EL PODER AHORA, EH, FOGOSILLO?	
VO_Ahune_Male_Elemental_Brawl_03	¡LA VENGANZA SE SIRVE FRÍA!	
VO_Ahune_Male_Elemental_Brawl_04	¿QUIÉN TIENE MÁS PROBABILIDADES DE MORIR A MANOS DE AVENTUREROS AHORA?	
VO_Ahune_Male_Elemental_Brawl_05	¿QUIÉN ES EL INSECTO AHORA?	
VO_Ahune_Male_Elemental_Brawl_07	¡LA PIEDRA DE HIELO SE HA FUNDIDO!	
VO_Ahune_Male_Elemental_Brawl_08	¿QUIÉN DESTRUIRÁ MÁS BUFONES?	
VO_Ahune_Male_Elemental_Brawl_11	¡UNA PUNTUACIÓN EXCELENTE!	
VO_Ahune_Male_Elemental_Brawl_15	¡HAY QUE DESTRUIR A RAGNAROS CON MÁS MALA UVA!	
VO_Ahune_Male_Elemental_Brawl_16	¡SE VE QUE ODIAS MUCHO A RAGNAROS!	
VO_Aran_Male_Shade_AranCrackle_01	Hum... En mis tiempos, Chisporroteo infligía 6 de daño.	
VO_Aran_Male_Shade_AranDeath_02	Otra vez no...	
VO_Aran_Male_Shade_AranEmoteResponse_01	¡Fuera, fuera!	
VO_Aran_Male_Shade_AranHeroPower_01	¡Arded, gamberros!	
VO_Aran_Male_Shade_AranMedivhSkin_01	¿Medivh? No, no... No importunaba a los invitados...	
VO_Aran_Male_Shade_AranOpen_01	Te voy a enseñar algo de respeto.	
VO_Aran_Male_Shade_AranSpell_03	¡A la fría oscuridad con vosotros!	
VO_Aran_Male_Shade_AranSpell_04	El amo es muy poderoso... ¡Pero yo tengo mis propios poderes!	
VO_Aran_Male_Shade_AranTrons_02	¡NO! ¡NO! ¡No lo soporto! ¡No puedo con sus "hola hola"!	
VO_Aran_Male_Shade_AranTurn1_01	¡No quiero música en mi torre!	
VO_Aran_Male_Shade_AranTurn5_01	¡No soy un simple juglar! ¡Soy Nielas Aran!	
VO_Barnes_Male_Human_FinalNazraTurn5_02	¡Socorro! ¡No nos quedan plátanos! ¡Mukkla está destrozando la despensa!	
VO_Barnes_Male_Human_JulianneTurn5_01	¿Qué es una fiesta sin una función? ¿Y una función sin público?	
VO_Barnes_Male_Human_JulianneWin_01	¡Fin del primer acto! ¡Quedan dos!	
VO_Barnes_Male_Human_Wing2Intro_02	¡Has llegado al teatro! Soy Barnes, el director de escena. Los portales para salvar a Medivh están en el piso de arriba, ¡pero antes debes ver la función!	
VO_Barnes_Male_Human_WolfBigMinion_01	Abuelita, ¡qué esbirros tan grandes tienes!	
VO_Barnes_Male_Human_WolfClaws_01	¡Calma! ¡Esas enormes garras son de atrezo!	
VO_Barnes_Male_Human_WolfTurn5_01	Me encanta que participe el público. ¡Huye, huésped! ¡Corre!	
VO_Barnes_Male_Human_WolfTurn9_01	Ja, ja, ¡qué gran espectáculo! ¡Mejor que el ogro que perseguimos el otro día!	
VO_Barnes_Male_Human_WolfWin_01	¡Ajá! ¡El gran final se acerca!	
VO_BigBadWolf_Male_Worgen_WolfBigMinion_01	¡Son para aplastarte mejor!	
VO_BigBadWolf_Male_Worgen_WolfDeath_01	¿Me han cazado? No...	
VO_BigBadWolf_Male_Worgen_WolfDireWolfAlpha_01	<Gruñido.>	
VO_BigBadWolf_Male_Worgen_WolfDireWolfAlpha_02	*Gemido*	
VO_BigBadWolf_Male_Worgen_WolfEmoteResponse_01	Mmmm... Qué delicia.	
VO_BigBadWolf_Male_Worgen_WolfOpen_01	¡Huye, criaturita! ¡Corre!	
VO_BigBadWolf_Male_Worgen_WolfScarletCrusader_01	Oh, Caperucita Roja, ¿adónde vas?	
VO_BigBadWolf_Male_Worgen_WolfTurn1_01	Mira a tus esbirros. ¿Has visto cómo tiemblan al verme?	
VO_BlackKing_Male_ChessPiece_ChessEmoteGreetings_01	Siempre.	
VO_BlackKing_Male_ChessPiece_ChessEmoteOops_01	¿O una trampa?	
VO_BlackKing_Male_ChessPiece_ChessEmoteSorry_01	Un sacrificio necesario.	
VO_BlackKing_Male_ChessPiece_ChessEmoteThanks	Un placer.	
VO_BlackKing_Male_ChessPiece_ChessEmoteThanks_01	Un placer.	
VO_BlackKing_Male_ChessPiece_ChessEmoteThreaten_01	Pues yo lo veo en tres.	
VO_BlackKing_Male_ChessPiece_ChessEmoteWellPlayed_01	Todavía no.	
VO_BlackKing_Male_ChessPiece_ChessEmoteWow_01	Naturalmente.	
VO_BlackKing_Male_ChessPiece_ChessOpen_01	¡Nadie pasará!	
VO_BOSS_AYA_Female_Pandaren_BC_0_Jade_Golem_02	¿Más gólems? ¡TOMA YA!	
VO_BOSS_AYA_Female_Pandaren_BC_0_Jade_Golem_03	¡Ji, ji, ji, ji, ji, ji! ¡TOMA EJÉRCITO!	
VO_BOSS_AYA_Female_Pandaren_BC_0_Jade_Golem_04	¡Otro! ¡OTROOO!	
VO_BOSS_AYA_Female_Pandaren_BC_2_1st_Turn_Start_01	Seh, claro… ¡Gadgetzan es solo mío!	
VO_BOSS_AYA_Female_Pandaren_BC_2_2nd_Turn_Start_01	Gadgetzan pertenece al Loto de Jade… ¡y el Loto de Jade me pertenece a mí!	
VO_BOSS_AYA_Female_Pandaren_BC_2_Arms_Dealing1_01	Más armas. Qué originalidad.	
VO_BOSS_AYA_Female_Pandaren_BC_2_Fill1_01	Ooooh, esto te va a encantar…	
VO_BOSS_AYA_Female_Pandaren_BC_2_Fill2_01	Nah, ¡me gusta este sitio! ¡Me quedaré!	
VO_BOSS_AYA_Female_Pandaren_BC_2_Goons_Win_01	¡No, no, no, no, no, no! ¡ESTO SÍ QUE NO!	
VO_BOSS_AYA_Female_Pandaren_BC_2_Goons_Winning_02	¡¿Por qué no te CALLAS?!	
VO_BOSS_AYA_Female_Pandaren_BC_2_Jade_Win_01	¡El Loto de Jade vuelve a ganar! ¡Soy lo más!	
VO_BOSS_AYA_Female_Pandaren_BC_2_Lotus_Winning_01	¡Ji, ji, ji! ¡Sigue jugando, sigue!	
VO_BOSS_AYA_Female_Pandaren_BC_3_1st_Turn_Start_01	¡Gadgetzan MOLA MOGOLLÓN! ¡Lo quiero para mí!	
VO_BOSS_AYA_Female_Pandaren_BC_3_1st_Turn_Start_02	Ji, ji, ji… Será un placer…	
VO_BOSS_AYA_Female_Pandaren_BC_3_2nd_Turn_Start_01	Los del Kabal sois unos mueeeermos de cuidado…	
VO_BOSS_AYA_Female_Pandaren_BC_3_Fill1_01	Qué buen día hace, ¿eh, Kazakito?	
VO_BOSS_AYA_Female_Pandaren_BC_3_Fill2_01	Uh, Kazakito, relájate. Intenta divertirte un poco.	
VO_BOSS_AYA_Female_Pandaren_BC_3_Jade_Golem3_01	¡Ji, ji, ji, ji!	
VO_BOSS_AYA_Female_Pandaren_BC_3_Kabal_Winning_01	Sí, cansada de tus mamarrachadas.	
VO_BOSS_AYA_Female_Pandaren_BC_3_Kabal_Wins_01	¡NO ME LO CREO! ¡NO, NO, NO, NO Y NO!	
VO_BOSS_AYA_Female_Pandaren_BC_3_Lotus_Winning_01	Ohhh, ¿qué te pasa, Kazakito? ¡Menuda paliza te están dando!	
VO_BOSS_AYA_Female_Pandaren_BC_3_Lotus_Wins_01	Me lo he pasado bien. ¡Gracias por jugar, Kazakito!	
VO_BOSS_AYA_Female_Pandaren_BC_3_Potion1_02	Bla, bla, bla, pociones, bla, bla, bla. ¡Ven aquí y LUCHA, cobarde!	
VO_BOSS_AYA_Female_Pandaren_BC_3_Potion3_01	¡Puaj! ¡Pero qué asco!	
VO_BOSS_AYA_Female_Pandaren_Concede_01	Bah, aguafiestas…	
VO_BOSS_AYA_Female_Pandaren_Greetings_01	¡Holaaa!	
VO_BOSS_AYA_Female_Pandaren_Oops_01	¡Ups!	
VO_BOSS_AYA_Female_Pandaren_START_01	¡Prepara los gólems!	
VO_BOSS_AYA_Female_Pandaren_Thanks_02	¡Muchas gracias!	
VO_BOSS_AYA_Female_Pandaren_Threaten_02	Mmm… Ahora tendrás que morir.	
VO_BOSS_AYA_Female_Pandaren_Well_Played_01	¡No está nada mal!	
VO_BOSS_AYA_Female_Pandaren_Wow_02	¡Guaaa!	
VO_BOSS_CHO_Male_Ogre_BC_1_1st_Turn_Start_01	¡LOS MUGRES APLASTAR FLORES!	
VO_BOSS_CHO_Male_Ogre_BC_1_Fill2_01	¡ATACAR, MUCHACHOS!	
VO_BOSS_CHO_Male_Ogre_BC_2_Fill1_01	¡QUÉ OJOS DE LOCA!	
VO_BOSS_CHO_Male_Ogre_Concede_01	SÍ, DIGO, NO. CULPA TUYA.	
VO_BOSS_CHO_Male_Ogre_Oops_02	UY, ERROR.	
VO_BOSS_CHO_Male_Ogre_Thanks_01	GRACIAS.	
VO_BOSS_HAN_Male_Ogre_BC_0_Arms_Dealing_01	Algo se ha caído de un camión… Je, je, je…	
VO_BOSS_HAN_Male_Ogre_BC_0_Arms_Dealing_02	¡Mugres a mí!	
VO_BOSS_HAN_Male_Ogre_BC_0_Arms_Dealing_03	¡Armad a ese Mugre y sacadlo ahí fuera!	
VO_BOSS_HAN_Male_Ogre_BC_0_Arms_Dealing_04	¡Los Matones Mugrientos son familia!	
VO_BOSS_HAN_Male_Ogre_BC_1_1st_Turn_Start_01	Este barrio no es para flores delicadas, Kazakus.	
VO_BOSS_HAN_Male_Ogre_BC_1_2nd_Turn_Start_01	Gadgetzan es de los Mugres, ¿capito?	
VO_BOSS_HAN_Male_Ogre_BC_1_2nd_Turn_Start_02	Me parece muy bien, pero Gadgetzan pertenece a los Mugres.	
VO_BOSS_HAN_Male_Ogre_BC_1_Fill1_01	No quiero ver más pociones de esas.	
VO_BOSS_HAN_Male_Ogre_BC_1_Fill2_01	Cho, llama a los Mugres. Este trol necesita... persuasión.	test
VO_BOSS_HAN_Male_Ogre_BC_1_Goons_Win_01	Lo siento, Kazakus. Los negocios son los negocios.	
VO_BOSS_HAN_Male_Ogre_BC_1_Goons_Winning_01	Vaya, Kazakus, ni que hubieras sufrido un... accidente.	
VO_BOSS_HAN_Male_Ogre_BC_1_Kabal_Win_02	Esto... no ha... acabado... Kazakus...	
VO_BOSS_HAN_Male_Ogre_BC_1_Kabal_Winning_02	Je. Sigues en forma, abuelo.	
VO_BOSS_HAN_Male_Ogre_BC_1_Potion1_01	No me gustan las pociones ni con lasaña.	
VO_BOSS_HAN_Male_Ogre_BC_1_Potion2_01	¡Eh, vigila adónde tiras eso!	
VO_BOSS_HAN_Male_Ogre_BC_2_1st_Turn_Start_01	¡Gadgetzan es nuestro! ¡Lárgate, pintamonas!	
VO_BOSS_HAN_Male_Ogre_BC_2_1st_Turn_Start_04	Sí, bueno, los Matones Mugrientos queremos decir algo al respecto...	
VO_BOSS_HAN_Male_Ogre_BC_2_Fill1_01	No me gusta esa mirada, Aya.	
VO_BOSS_HAN_Male_Ogre_BC_2_Goons_Win_01	Tranquilízate, Aya. Je, je, te vendrá bien.	
VO_BOSS_HAN_Male_Ogre_BC_2_Goons_Winning_01	¿No quieres replantearte tu bando?	
VO_BOSS_HAN_Male_Ogre_BC_2_Jade_Golem2_01	Estos tipos de jade empiezan a cansarme.	
VO_BOSS_HAN_Male_Ogre_BC_2_Lotus_Win_01	Agh… Gadgetzan… será… nuestro…	
VO_BOSS_HAN_Male_Ogre_BC_2_Lotus_Winning_01	Argh… Llevaos de aquí a esta cría.	
VO_BOSS_HAN_Male_Ogre_Concede_01	¡Toda la culpa es tuya!	
VO_BOSS_HAN_Male_Ogre_Greetings_01	Gadgetzan te da la bienvenida.	
VO_BOSS_HAN_Male_Ogre_INTRO_PACK_OPEN_7	Un momento… ¿Quién es ese apuesto galán? Je, je, je.	
VO_BOSS_HAN_Male_Ogre_Oops_01	Mamma mia...	
VO_BOSS_HAN_Male_Ogre_START_01	Ahora estás en nuestro territorio.	
VO_BOSS_HAN_Male_Ogre_Thanks_01	Has cumplido un gran servicio.	test
VO_BOSS_HAN_Male_Ogre_Threaten_01	Mis ofertas no se rechazan…	
VO_BOSS_HAN_Male_Ogre_Well_Played_02	Tengo que admitir que me has impresionado.	
VO_BOSS_HAN_Male_Ogre_WOW_01	No está mal.	
VO_BOSS_KAZAKUS_Male_Troll_BC_0_Potion_01	Ah, qué refrehcante...	
VO_BOSS_KAZAKUS_Male_Troll_BC_0_Potion_02	¡Toma ehto!	
VO_BOSS_KAZAKUS_Male_Troll_BC_0_Potion_04	Acábatela toda...	
VO_BOSS_KAZAKUS_Male_Troll_BC_0_Potion_05	¡¿A qué sabe, eh?!	
VO_BOSS_KAZAKUS_Male_Troll_BC_1_1st_Turn_Start_01	¡Gadgetzan será mío, Han'Cho!	
VO_BOSS_KAZAKUS_Male_Troll_BC_1_2nd_Turn_Start_01	El Kabal ehtá en todah parteh. Gadgetzan ehtá a nuehtroh pieh.	
VO_BOSS_KAZAKUS_Male_Troll_BC_1_Arms_Dealing1_01	Mmm... La clásica cobardía de loh Mugreh. ¡SALID DE LA MANO!	
VO_BOSS_KAZAKUS_Male_Troll_BC_1_Fill1_01	El Kabal controla un poder infinito.	
VO_BOSS_KAZAKUS_Male_Troll_BC_1_Goons_Win_01	¡Volveré, y máh poderoso que nunca!	
VO_BOSS_KAZAKUS_Male_Troll_BC_1_Goons_Winning_01	¡Sufriráh eternamente, Han'Cho!	
VO_BOSS_KAZAKUS_Male_Troll_BC_1_Kabal_Win_01	Claro que sí.	
VO_BOSS_KAZAKUS_Male_Troll_BC_1_Kabal_Winning_01	¡El dehtino te aguarda, Han'Cho!	
VO_BOSS_KAZAKUS_Male_Troll_BC_3_1st_Turn_Start_01	¡Ja, ja, ja! Para eso tendráh que vencerme.	
VO_BOSS_KAZAKUS_Male_Troll_BC_3_Fill1_01	¡NO ME LLAMEH ASÍ, NIÑA INSOLENTE!	
VO_BOSS_KAZAKUS_Male_Troll_BC_3_Fill2_01	¡Ríndete ante el poder del Kabal!	
VO_BOSS_KAZAKUS_Male_Troll_BC_3_Jade_Golem2_01	¡Niña insolente! ¿Osah mofarte del líder máh poderoso de Gadgetzan?	
VO_BOSS_KAZAKUS_Male_Troll_BC_3_Jade_Golem3_01	¡Insolente! Ya bahta de ehta tontería de loh gólem.	
VO_BOSS_KAZAKUS_Male_Troll_BC_3_Kabal_Winning_01	¡Pareceh cansada, niñita!	
VO_BOSS_KAZAKUS_Male_Troll_BC_3_Kabal_Winning_02	¡¿Qué?! ¡Será posible! ¡YO seré TU FIN!	test
VO_BOSS_KAZAKUS_Male_Troll_BC_3_Kabal_Wins_01	¡Ja, ja! ¡Una víctima máh del poder del Kabal!	
VO_BOSS_KAZAKUS_Male_Troll_BC_3_Lotus_Winning_01	Será descarada...	
VO_BOSS_KAZAKUS_Male_Troll_BC_3_Lotus_Wins_01	¡Insensata! ¡Ehto no ha terminadooo...!	
VO_BOSS_KAZAKUS_Male_Troll_BC_3_Potion1_01	Siente la furia de lah pocioneh del Kabal.	
VO_BOSS_KAZAKUS_Male_Troll_Concede_01	Ehtah... calleh... me... pertenecen...	
VO_BOSS_KAZAKUS_Male_Troll_Greetings_02	¡Saludoh, ignoranteh!	test
VO_BOSS_KAZAKUS_Male_Troll_Mirror_Start_01	Ereh bahtante hábil.	
VO_BOSS_KAZAKUS_Male_Troll_Oops_01	Un error de cálculo.	
VO_BOSS_KAZAKUS_Male_Troll_START_01	El maná me llama...	
VO_BOSS_KAZAKUS_Male_Troll_Thanks_01	Te lo agradezco, peón.	
VO_BOSS_KAZAKUS_Male_Troll_Threaten_01	¡YO CONTROLO GADGETZAN!	
VO_BOSS_KAZAKUS_Male_Troll_Well_Played_02	Tu potencial ehtá por ehplotar...	
VO_BOSS_KAZAKUS_Male_Troll_Wow_01	¡El poder eh intenso en ti!	
VO_BRANN_MITHRIL_ALT_02	Fascinante. Estas runas de mitril contienen código de guardián. ¡Deben datar de la era de los titanes!	
VO_BRANN_WIN_07_ALT_07	¡Los hemos perdido! ¡La cabeza del bastón está en la siguiente sala!	
VO_BRM_027h_Death_63	¡No! ¡NO! ¡NOOOOOOOOOOOO!!!!	
VO_BRMA01_1_CARD_05	Venga, ¡démosles una cálida bienvenida!	
VO_BRMA01_1_DEATH_09	Jo, jo, jo. ¿Qué? Ah, no me gusta nada, pero va a ocurrir de todas formas.	
VO_BRMA01_1_ETC_06	¡Es la hora del espectáculo! ¡Un fuerte aplauso para Elite Tauren Chieftain!	
VO_BRMA01_1_HERO_POWER_04	¡Ja, ja, ja! ¡Más peña!	
VO_BRMA01_1_RESPONSE_03	Ja, ja, ja… ¡hip! ¡Uy, perdón!	
VO_BRMA01_1_START_01	¡Te doy la bienvenida al Tragapenas!	
VO_BRMA01_1_SUCCUBUS_08	¡Coima Nagmara! Creo que a mi "colega" le sentaría bien un "trago".	
VO_BRMA01_1_TURN1_02	¡Atención! Ja, ja. Mira por dónde… tenemos visita.	
VO_BRMA01_1_WARGOLEM_07	¡Jo, jo, jo! ¡Estás en apuros! ¡Falange! ¡Ataca!	
VO_BRMA02_1_ALAKIR_34	¡A este señor elemental le encanta aplastar insectos! ¡Al'Akir!	
VO_BRMA02_1_ALEXSTRAZA_32	Protectora, reina de los dragones, combatiente de la Arena Hierro Negro… ¡Alexstrasza!	
VO_BRMA02_1_BEAST_22	Le encanta comer gnomos, pero está dispuesta a hacer una excepción. ¡Es la Bestia!	
VO_BRMA02_1_BOOM_28	¡Espero que todos estéis a cubierto, porque nuestro siguiente contrincante es el Dr. Bum!	
VO_BRMA02_1_CAIRNE_20	Está educando a su hijo para que siga sus huellas. ¡Un aplauso para Cairne Pezuña de Sangre!	
VO_BRMA02_1_CHO_07	Es la hora del cuento con el pandaren más adorable: ¡el eremita Cho!	
VO_BRMA02_1_DEATH_38	¡Hjt! ¿Eh? ¡Aah! ¡Uf!	
VO_BRMA02_1_DEATHWING_35	¡Uuuuh! ¡Señoras y señores! El único, el inigualable… ¡ALAMUERTE!	
VO_BRMA02_1_ETC_18	Y ahora, el tauren, el mito, la leyenda… ¡Elite Tauren Chieftain!	
VO_BRMA02_1_FEUGEN_15	¡Un aplauso para Feugen!	
VO_BRMA02_1_FOEREAPER_29	Programada mecánicamente para la máxima destrucción, ¡es la Siegaenemigos 4000!	
VO_BRMA02_1_GEDDON_13	Uuh, ¡la Arena se está calentando! ¡Demos la bienvenida al barón Geddon!	
VO_BRMA02_1_GELBIN_21	Recién llegado de Nueva Ciudad Manitas, ¡saludad al jefe de los gnomos, Gelbin Mekkatorque!	
VO_BRMA02_1_GRUUL_31	¡Si lo llaman el Asesino de Dragones es por algo! ¡Un aplauso para Gruul!	
VO_BRMA02_1_HERO_POWER_05	¡El público se está impacientando! ¡Ja, ja, ja, ja!	
VO_BRMA02_1_HOGGER_27	Saludad al gnoll de nivel 11 que se convirtió en leyenda en sus ratos libres: ¡Hogger!	
VO_BRMA02_1_ILLIDAN_23	¿Quién necesita ojos teniendo gujas gemelas? ¡Illidan Tempestira no, desde luego!	
VO_BRMA02_1_LEVIATHAN_12	Recién restaurado y listo para destruir, ¡el Leviatán de llamas!	
VO_BRMA02_1_LOATHEB_16	Tapaos la nariz, cubríos la boca y animad a la podredumbre personificada: ¡Loatheb!	
VO_BRMA02_1_MAEXXNA_24	¡Aquí llega la araña gigante! ¿Y cuál es su nombre? ¡Maexxna!	
VO_BRMA02_1_MILLHOUSE_09	¿Quién ha dejado entrar a ese en la Arena?	
VO_BRMA02_1_MOGOR_25	Su vocabulario es limitado, pero su cólera no tiene fin. ¡Mogor el ogro!	
VO_BRMA02_1_MUKLA_10	Y ahora, el señor de los plátanos: ¡el rey Mukla!	
VO_BRMA02_1_NOZDORMU_36	Señoras y… ¡ups! Se acabó el tiempo.	
VO_BRMA02_1_ONYXIA_33	Recién llegada de Marjal Revolcafango y del castillo de Ventormenta, ¡Onyxia!	
VO_BRMA02_1_PAGLE_08	De vuelta de su viaje de pesca, ¡el maestro pescador Nat Pagle!	
VO_BRMA02_1_RESPONSE_04	¡Nadie puede sobrevivir a todas estas leyendas!	
VO_BRMA02_1_SNEED_30	¡El siguiente contrincante se esconde tras los controles de una vieja trituradora! ¿Quién será?	
VO_BRMA02_1_STALAGG_14	¿Logrará Stalagg sobrevivir en la Arena? ¡Veámoslo!	
VO_BRMA02_1_START_01	¡Un nuevo desafío!	
VO_BRMA02_1_SYLVANAS_19	Su odio eterno arde para vosotros. ¡Demos la bienvenida a Sylvanas Brisaveloz!	
VO_BRMA02_1_THALNOS_06	Un aplauso para el esqueleto con botas: ¡el mago sangriento Thalnos!	
VO_BRMA02_1_THAURISSAN_37	Recién llegado de una misión posterior a esta, ¡el emperador Thaurissan!	
VO_BRMA02_1_TINKMASTER_11	¡Un fuerte aplauso para el gran inventor, el maestro manitas Sobrechispa!	
VO_BRMA02_1_TOSHLEY_26	Este gnomo se encuentra lejos de su hogar. ¡Dad la bienvenida a Toshley!	
VO_BRMA02_1_TURN1_02	¡Enanas y enanos! ¡Menudo espectáculo tenemos preparado!	
VO_BRMA02_1_TURN1_PT2_03	¡Un solo individuo contra las mayores leyendas de Azeroth!	
VO_BRMA02_1_VOLJIN_17	¡Silencio! Tenemos un invitado especial: ¡el Jefe de Guerra Vol'jin!	
VO_BRMA03_1_CARD_04	Por el poder de Ragnaros, ¡yo tengo el poder!	
VO_BRMA03_1_DEATH_09	¡Aaaaaaaaaah!	
VO_BRMA03_1_HERO_POWER_06	¡¡¡Muereee!!!	
VO_BRMA03_1_MOIRA_DEATH_05	¡No! ¡Moira! ¡ME LAS PAGARÁS!	
VO_BRMA03_1_RESPONSE_03	¡Cierra la boca o te la cierro yo!	
VO_BRMA03_1_START_01	¡Los enanos Hierro Negro jamás caerán!	
VO_BRMA03_1_TURN1_02	¡Eh! ¡Deja a mi mujer en paz!	
VO_BRMA03_1_VS_RAG_07	¡No! ¡Ragnaros! ¡Otra vez no!	
VO_BRMA04_1_CARD_04	Jurafuegos, ¡vamos allá!	
VO_BRMA04_1_DEATH_06	¡Rrrrrrrrrrrrh!	
VO_BRMA04_1_HERO_POWER_05	¡Magma!	
VO_BRMA04_1_RESPONSE_03	Piedra siempre gana.	
VO_BRMA04_1_START_01	Te voy a dejar de piedra.	
VO_BRMA04_1_TURN1_02	Te haré pedazos.	
VO_BRMA05_1_CARD_05	¡Tic, tac, mortal!	
VO_BRMA05_1_DEATH_04	Un último servicio...	
VO_BRMA05_1_HERO_POWER_06	¡Arde!	
VO_BRMA05_1_RESPONSE_03	¡Armagedón!	
VO_BRMA05_1_START_01	¡Arderás!	
VO_BRMA05_1_TURN1_02	¡Ragnaros te consumirá!	
VO_BRMA06_1_DEATH_04	¡Me rindo! ¡Me rindo!	
VO_BRMA06_1_RESPONSE_03	¿Crees que ya has ganado? ¡Pues yo creo que necesitas otra lección de dolor!	
VO_BRMA06_1_START_01	¡Nadie puede desafiar a la llama eterna!	
VO_BRMA06_1_SUMMON_RAG_05	¡Contemplad a Ragnaros, el que ya era anciano cuando el mundo aún era joven!	
VO_BRMA06_1_TURN1_02_ALT	¡Perseguidlo!	
VO_BRMA06_3_INTRO_01	¡DEMASIADO PRONTO! ¡ME HAS DESPERTADO DEMASIADO PRONTO, EXECUTUS!	
VO_BRMA06_3_RESPONSE_03	¿¿¿QUÉ SIGNIFICA ESTA INTRUSIÓN???	
VO_BRMA06_3_TURN1_02	¡MORTAL! ¿TE ATREVES A ENTRAR EN MIS DOMINIOS?	
VO_BRMA07_1_CARD_04	¡Hora de machacar!	
VO_BRMA07_1_DEATH_06	¡Rrrnoooooo!	
VO_BRMA07_1_HERO_POWER_05	¡Yo machacar! ¡Tú morir!	
VO_BRMA07_1_RESPONSE_03	¡¡¡Raaar!!! ¡Yo machacar!	
VO_BRMA07_1_START_01	¡Yo aplastarte!	
VO_BRMA07_1_TURN1_02	¿Aplastar o machacar? ¡DECISIÓN DIFÍCIL!	
VO_BRMA08_1_CARD_05	¡Protegeré la Cumbre!	
VO_BRMA08_1_DEATH_06	Rrh. ¡Aah! ¡Noooooo!	
VO_BRMA08_1_RESPONSE_04	¡¿Por qué?! ¡Dime por qué! Me gustabas.	
VO_BRMA08_1_START_01	¿¿Qué haces tú aquí??	
VO_BRMA08_1_TURN1_03	¡Lord Nefarius! ¿No fue este sujeto quien se encargó de Ragnaros por nosotros?	
VO_BRMA08_1_TURN1_ALT_02	¿Vienes para ayudarme a destruir a los mortales de este mundo?	
VO_BRMA09_1_CARD_05	¡La Cumbre es NUESTRA!	
VO_BRMA09_1_DEATH_11	¡Gaaaaaaah!	
VO_BRMA09_1_HERO_POWER1_06	¡Abrid las puertas!	
VO_BRMA09_1_HERO_POWER2_07	¡Hay que matar al del fondo!	
VO_BRMA09_1_HERO_POWER3_08	¡Centraos en el héroe, necios!	
VO_BRMA09_1_HERO_POWER4_09	¡Juntos somos IMPARABLES!	
VO_BRMA09_1_RESPONSE_04	¡Muajajajaja!	
VO_BRMA09_1_START_01	¡Somos la verdadera Horda!	
VO_BRMA09_1_TURN1_03	¡Estás escalando la montaña equivocada!	
VO_BRMA09_1_TURN1_ALT_02	¡Nadie nos detendrá! ¡¡¡MUERE!!!	
VO_BRMA10_1_DEATH_08	¡Rrrrrrrrrrrh!	
VO_BRMA10_1_EGG_DEATH_1_05	¡Loco! ¡Esos huevos son más valiosos de lo que crees!	
VO_BRMA10_1_EGG_DEATH_2_06	¡No, otro no! ¡Rodará tu cabeza por esta infamia!	
VO_BRMA10_1_EGG_DEATH_3_07	¡Pagarás por esto!	
VO_BRMA10_1_HERO_POWER_04	¡Aléjate de esos huevos!	
VO_BRMA10_1_RESPONSE_03	¡Te haré picadillo!	
VO_BRMA10_1_START_01	¡Contempla los huevos corruptos de nuestro nuevo Vuelo!	
VO_BRMA10_1_TURN1_02	¡Estos huevos serán tu perdición!	
VO_BRMA11_1_ALEXSTRAZA_07	Ayúdame. ¡Protectora! ¡Ayúdame!	
VO_BRMA11_1_CARD_04	¡La furia de Roca Negra corre por mis venas!	
VO_BRMA11_1_DEATH_ALT_08	Por fin termina la agonía...	
VO_BRMA11_1_HERO_POWER_05	¡Aaaah! ¡Destrucción!	
VO_BRMA11_1_KILL_PLAYER_06	Perdóname, he fracasado.	
VO_BRMA11_1_RESPONSE_03	¡Deberías haber escapado mientras podías, mortal!	
VO_BRMA11_1_START_01	¡Huye! ¡Antes de que pierda el control!	
VO_BRMA11_1_TURN1_02	Demasiado tarde… ¡Ahora estoy poseído por la corrupción de Nefarian!	
VO_BRMA13_1_DEATH_ALT_23	¡NO! ¡VOLVERÉEEE!	
VO_BRMA13_1_DEATHWING_19	¿¿Papi??	
VO_BRMA13_1_HP_DRUID_14	Druida, ¡yo controlo lo salvaje!	
VO_BRMA13_1_HP_GENERIC_18	¡Tu magia me pertenece!	
VO_BRMA13_1_HP_HUNTER_12	¡El cazador se convierte en presa!	
VO_BRMA13_1_HP_MAGE_11	Mago, deberías tener más cuidado al jugar con magia.	
VO_BRMA13_1_HP_PALADIN_07	Paladín, ¿te ha abandonado la Luz?	
VO_BRMA13_1_HP_PRIEST_08	Sacerdote, ¡ahora la Luz me sirve a mí!	
VO_BRMA13_1_HP_ROGUE_15	Pícaro, ¡sal y enfréntate a mí!	
VO_BRMA13_1_HP_SHAMAN_13	Chamán, ahora los elementos me obedecen a mí.	
VO_BRMA13_1_HP_WARLOCK_10	Brujo, ¡juegas con magia que escapa a tu comprensión!	
VO_BRMA13_1_HP_WARRIOR_09	Guerrero, ¡tu fuerza es tu debilidad!	
VO_BRMA13_1_RESPONSE_05	¡Yo soy aquí el maestro!	
VO_BRMA13_1_START_01	¡Te doy la bienvenida a mi sagrario personal!	
VO_BRMA13_1_TURN1_PT1_02	¡Ja, ja, ja! ¡Contempla el verdadero poder de NEFARIAN!	
VO_BRMA13_1_TURN1_PT2_03	¡Maná infinito! ¡Dragontina acorazada!	
VO_BRMA14_1_CARD_09	Redirigiendo exceso de energía.	
VO_BRMA14_1_DEATH_08	Sistemas de defensa destruidos. Apagando…	
VO_BRMA14_1_HP1_03	Unidad Electron activada.	
VO_BRMA14_1_HP2_04	Unidad Toxitron activada.	
VO_BRMA14_1_HP3_05	Unidad Arcanotron activada.	
VO_BRMA14_1_HP4_06	Unidad Magmatron activada.	
VO_BRMA14_1_HP5_07	Unidad de defensa conectada.	
VO_BRMA14_1_RESPONSE1_10	Bip, bop, bip.	
VO_BRMA14_1_RESPONSE2_11	Intentando conectar.	
VO_BRMA14_1_RESPONSE3_12	Conexión establecida. Descargando actualizaciones.	
VO_BRMA14_1_RESPONSE4_13	Actualización instalada. ¡Hola! ¡Hola! ¡Hola!	
VO_BRMA14_1_RESPONSE5_14	¡Hola! ¡Hola! ¡Hola!	
VO_BRMA14_1_START_01	Detectados intrusos.	
VO_BRMA14_1_TURN1_02	Iniciada matriz de defensa primaria.	
VO_BRMA15_1_CARD_05	¡Mis fracasos serán vuestra caída!	
VO_BRMA15_1_DEATH_04	¡Aaaaaaaahhhhh!	
VO_BRMA15_1_HERO_POWER_06	Mezclar y agitar, aplicar calor...	
VO_BRMA15_1_RESPONSE_03	¡Todo se aprovecha!	
VO_BRMA15_1_START_01	¡No, no puede haber interrupciones!	
VO_BRMA15_1_TURN1_02	¡Ooh! ¡No debo hacer esperar al maestro! ¡No debo fallar otra vez!	
VO_BRMA16_1_CARD_04	No puedes esconderte.	
VO_BRMA16_1_DEATH_06	¡Rrrraaaaaaaah!	
VO_BRMA16_1_GONG1_10	¡Aah! ¡¡Ese sonido!!	
VO_BRMA16_1_GONG2_11	¡Noo! ¡¡Qué cerca!!	
VO_BRMA16_1_GONG3_12	¡¡MIS OÍDOS!!	
VO_BRMA16_1_HERO_POWER_05	¡Tus torpes pasos y tu hediondo olor te delatan!	
VO_BRMA16_1_RESPONSE_03	Sí, habla, ¡me estoy acercando!	
VO_BRMA16_1_START_01	¡Oigo los latidos de tu corazón!	
VO_BRMA16_1_TRIGGER1_07	¡Ah! Te oigo…	
VO_BRMA16_1_TRIGGER2_08	Oigo pasos.	
VO_BRMA16_1_TRIGGER3_09	Oigo los latidos de tu corazón. ¡No puedes huir!	
VO_BRMA16_1_TURN1_02	¡La muerte aguarda en la oscuridad!	
VO_BRMA17_1_CARD_86	Espero que sepas nadar… ¡EN LAVA FUNDIDA!	
VO_BRMA17_1_DEATH_97	¡Aaaaaaaaaaah!	
VO_BRMA17_1_DEATH_HEROIC_98	¡NOOOOOOOOOO!	
VO_BRMA17_1_DEATHWING_88	¿¿PAPI??	
VO_BRMA17_1_HERO_POWER_87	¡Mi llama de las sombras da vida a sus huesos!	
VO_BRMA17_1_NEF_AIR1_89	¡Mírame lanzar fuego desde arriba! ¡1 p. de daño es solo el principio!	
VO_BRMA17_1_NEF_AIR2_90	¡Dos bolas de fuego! ¡Las lanzo desde lo alto!	
VO_BRMA17_1_NEF_AIR3_91	Esta vez solo lanzaré una bola de fuego porque me estoy reservando para un turno glorioso.	
VO_BRMA17_1_NEF_AIR4_92	¡Jo, jo! ¡Tres bolas de fuego! ¡Toma ya! ¡Desde arriba!	
VO_BRMA17_1_NEF_AIR5_93	¡Desde ahora solo lanzaré una bola de fuego!	
VO_BRMA17_1_NEF_AIR6_94	¡Era broma! ¡CUATRO bolas de fuego! ¡Ja, ja, ja!	
VO_BRMA17_1_NEF_AIR7_95	Esta vez no lanzaré ninguna bola de fuego. Pero prepárate…	
VO_BRMA17_1_NEF_AIR8_96	¡VEINTE BOLAS DE FUEGO! ¡JA, JA, JA!	
VO_BRMA17_1_RESPONSE_85	Mentes mortales... Tan fáciles de manipular.	
VO_BRMA17_1_RESURRECT1_82	¡La destrucción llegará desde arriba!	
VO_BRMA17_1_RESURRECT2_83	Estoy arriba, ¡pero tengo una sorpresa para ti ahí abajo!	
VO_BRMA17_1_RESURRECT3_84	¡Contempla mi creación definitiva! ¡Álzate, hermana! ¡Álzate, Onyxia!	
VO_BRMA17_1_START_78	¡Has llegado hasta el glorioso final!	
VO_BRMA17_1_TRANSFORM1_80	He intentado ser un buen anfitrión, ¡PERO NO MUERES!	
VO_BRMA17_1_TRANSFORM2_81	Es hora de dejarnos de tonterías y simplemente... ¡MATARTE!	
VO_BRMA17_1_TURN1_79	Mi creación definitiva espera, mortal.	
VO_COOP02_00	¡Os purificaré a ambos de la maldición de la carne!	
VO_COOP02_02	¡Derrotad al maestro de palancas Mecazod para ganar!	
VO_COOP02_ABILITY_05	¡Voy a darle cuerda!	
VO_COOP02_ABILITY_06	¡Hora de cerrar la imprenta, eremita Cho!	
VO_COOP03_01	¡Yo soy aquí el maestro!	
VO_COOP03_02	¡No! ¡No! ¡Te destruiré!	
VO_COOP03_03	Mentes mortales... Tan fáciles de manipular.	
VO_COOP03_04	He intentado ser un buen anfitrión, ¡PERO NO MUERES!	
VO_COOP03_05	Es hora de dejarnos de tonterías y simplemente... ¡MATARTE!	
VO_COOP03_06	Sacerdote, ¡ahora la Luz me sirve a mí!	
VO_COOP03_07	Chamán, ahora los elementos me obedecen a mí.	
VO_COOP03_08	¡Ja, ja, ja! ¡Contempla el verdadero poder de Nefarian!	
VO_COOP03_09	¡Ja, ja, ja! ¡Has llegado hasta el glorioso final!	
VO_Crone_Female_Troll_CroneDeath_02	¡No! ¡Caeráh en mi poder! Cae... ráh...	
VO_Crone_Female_Troll_CroneEmoteResponse_02	¡Jaaa, ja, ja, ja, ja!	
VO_Crone_Female_Troll_CroneFlyingMonkeys_01	¡Traedme a la niña!	
VO_Crone_Female_Troll_CroneHeroPower_02	¡Ji, ji, ji ji!	
VO_Crone_Female_Troll_CroneOpen_01	¡Ja, ja, ja, ja! ¡Volad, queridoh míoh!	
VO_Curator_Male_ArcaneGolem_CuratorArcaneGolem_01	Curioso. El parecido es extraordinario.	
VO_Curator_Male_ArcaneGolem_CuratorBeasts_01	Este Curator es alérgico a las bestias.	
VO_Curator_Male_ArcaneGolem_CuratorDemons_01	Los demonios no deberían estar aquí.	
VO_Curator_Male_ArcaneGolem_CuratorDragons_01	No más excrementos de dragón.	
VO_Curator_Male_ArcaneGolem_CuratorEmoteResponse_01	No se puede procesar tu petición.	
VO_Curator_Male_ArcaneGolem_CuratorHarrison_02	¡Ladrón detectado! Harrison Jones no puede entrar aquí.	
VO_Curator_Male_ArcaneGolem_CuratorMechs_01	Reprogramando ayudantes.	
VO_Curator_Male_ArcaneGolem_CuratorMedivhSkin_01	Falso Medivh detectado. Tiene ojos de demente.	
VO_Curator_Male_ArcaneGolem_CuratorMurlocs_01	Soltando pezqueñín.	
VO_Curator_Male_ArcaneGolem_CuratorPirates_01	Los piratas arrrmarán una buena.	
VO_Curator_Male_ArcaneGolem_CuratorReno_02	¡Ladrón detectado! Reno Jackson no puede entrar aquí.	
VO_Curator_Male_ArcaneGolem_CuratorTurn1_01	Este Curator está equipado para gestionar la Sala de las Fieras.	
VO_Curator_Male_ArcaneGolem_CuratorTurn5_01	Sigue los protocolos de la galería.	
VO_Curator_Male_ArcaneGolem_CuratorTurn9_01	Los invitados deben permanecer en la Sala de las Fieras.	
VO_Curator_Male_ArcaneGolem_IllhoofKilrekResponse_01	A este Curator no le importa. Está prohibido invocar.	
VO_Curator_Male_ArcaneGolem_IllhoofSenseDemons_01	Múltiples demonios detectados.	
VO_Curator_Male_ArcaneGolem_IllhoofTurn1_01	Los rituales de invocación están prohibidos.	
VO_Curator_Male_ArcaneGolem_IllhoofTurn5_01	Los rituales dañan a los inquilinos. El demonio no debe seguir.	
VO_Curator_Male_ArcaneGolem_IllhoofWin_01	Este Curator te lo agradece. La Sala de las Fieras se restablecerá.	
VO_Curator_Male_ArcaneGolem_NightbaneCorruption_01	¡No! ¡La Sala de las Fieras no debe corromperse!	
VO_Curator_Male_ArcaneGolem_NightbaneTour_01	La magia descontrolada pervirtió la mente del dragón Nocturno, antes conocido como Arcanagos.	
VO_Curator_Male_ArcaneGolem_NightbaneTour_02	A la izquierda, un busto de Aran. A la derecha, el Farol de poder.	
VO_Curator_Male_ArcaneGolem_NightbaneTurn1_01	Las criaturas pueden sufrir daño. Deben regresar a la Sala de las Fieras.	
VO_Curator_Male_ArcaneGolem_NightbaneTurn3_01	Primero, hay que salvar a las criaturas. Luego, podrás continuar.	
VO_Curator_Male_ArcaneGolem_NightbaneUnstablePortal_01	Los invitados deben ir con cuidado. Este dragón teme la magia inestable.	
VO_Curator_Male_ArcaneGolem_NightbaneWin_01	Se requiere ayuda adicional.	
VO_Curator_Neither_ArcaneGolem_CuratorDeath_04	Des-co-ne-xióoon...	
VO_Curator_Neither_ArcaneGolem_CuratorOpen_01	No toques la exposición.	
VO_ELISE_LOE16_ALT_1_FIRST_HALF_02	Mientras el bastón se carga, Rafaam es invulnerable.	
VO_ELISE_LOE16_ALT_1_SECOND_HALF_03	Cuando acabe, podremos atacarlo, ¡pero también habrá que lidiar con la criatura que invoque!	
VO_ELISE_WEIRD_DECK_05	Perdón por el mazo. Lo creamos para un torneo el año pasado y no lo hemos actualizado.	
VO_EMOTE_HERO_TBKTRAF_KT_DRAWING_BOARD	Vuelta al punto de partida...	
VO_EMOTE_HERO_TBKTRAF_KT_GLOAT	Suplica clemencia.	
VO_EMOTE_HERO_TBKTRAF_KT_MINIONS_SERVANTS	Esbirros, sirvientes, soldados de la fría oscuridad...	
VO_FP1_014t_EnterPlay_01	¡Ahora sientes dolor!	
VO_FP1_031_Attack_07	Corderos al matadero...	
VO_FP1_031_EnterPlay_06	¡La Plaga te consumirá!	
VO_HRW_DEBUG_01	1	
VO_HRW_DEBUG_02	2	
VO_HRW_DEBUG_03	3	
VO_HRW_DEBUG_04	4	
VO_HRW_DEBUG_05	5	
VO_HRW_TEST_00	¡Os purificaré a ambos de la maldición de la carne!	
VO_HRW_TEST_01	¡Bien hecho! Habéis derrotado al jefe juntos.\n\n¡Ganan ambos jugadores!	
VO_HRW_TEST_02	¡Derrotad al maestro de palancas Mecazod para ganar!	
VO_HRW_TEST_ABILITY_00	Dañando a un héroe.	
VO_HRW_TEST_ABILITY_01	Destruyendo al esbirro con mayor ataque.	
VO_HRW_TEST_ABILITY_02	Lanzando 3 bombas.	
VO_HRW_TEST_ABILITY_03	Dañando a todos los demás personajes.	
VO_HRW_TEST_ABILITY_04	Obteniendo 2 de ataque.	
VO_HRW_TEST_ABILITY_05	Infligiendo daño a ambos héroes.	
VO_HRW_TEST_ABILITY_06	Silenciando al eremita Cho permanentemente.	
VO_HRW_TEST_ABILITY_98	Diana llena. Limpiando diana.	
VO_Illhoof_Male_Demon_IlhoofKilrek_01	Ven, Kil'rek, ¡hay que completar la invocación!	
VO_Illhoof_Male_Demon_IllhoofDeath_02	¡No! ¡Casi lo consigo! Sar... ge...	
VO_Illhoof_Male_Demon_IllhoofEmoteResponse_01	¡Tu esencia alimenta el ritual!	
VO_Illhoof_Male_Demon_IllhoofOpen_01	¡Ah, justo a tiempo!	
VO_Illhoof_Male_Demon_IllhoofSummonImps_01	¡A mí, habitantes de la oscuridad! ¡Acudid a mi llamada!	
VO_Illhoof_Male_Demon_IllhoofSummoningPortal_01	¿Un portal sin un ritual? Parece mucho más fácil...	
VO_Illhoof_Male_Demon_IllhoofTurn1_01	¡El ritual empieza ya!	
VO_Illhoof_Male_Demon_IllhoofWounded_01	Venid, mascotas mías. ¡Hay que completar el ritual!	
VO_Jaraxxus_Male_Demon_FinalMalchezaarJaraxxus_01	Pobre principito... ¡Practica en el karaoke como Jaraxxus!	
VO_Jaraxxus_Male_Demon_FinalMalchezaarJaraxxus_02	Estamos aquí... Llegamos al fin... Hay sitio en nuestras filas...	
VO_Julianne_Female_Human_JulianneDeath_01	¡Romulo! Bebo en tu honor...	
VO_Julianne_Female_Human_JulianneEmoteResponse_01	¿Nos hacéis burla?	
VO_Julianne_Female_Human_JulianneFeignDeath_03	Para despertar como de un grato sueño.	
VO_Julianne_Female_Human_JulianneHeroPower_01	Ven a mí, gentil noche, ¡y devuélveme a mi Romulo!	
VO_Julianne_Female_Human_JulianneOpen_01	¿Qué demonio sois?	
VO_KAR03_MOROES_MALE_HUMAN_CHESS_TURN_1	Aquí, las piezas atacan automáticamente al final de tu turno.	
VO_KAR03_MOROES_MALE_HUMAN_CHESS_TURN_3	Si una pieza se encuentra entre dos enemigos, ¡atacará a los dos!	
VO_KAR03_MOROES_MALE_HUMAN_CHESS_TURN_5	Para ganar hay que saber posicionarse. ¡Aprovecha los ataques dobles!	
VO_KARA_04_01_Female_Human_CroneHuffer_01	Bufar, me parece que ya no estamos en Páramos de Poniente...	
VO_KARA_04_01_Female_Human_CroneLionTigerBear_02	¡Oh! ¡Leones, dragones y osos!	
VO_KARA_04_01_Female_Human_CroneTurn1_01	¡Oh, no! ¡No permitas que me haga daño!	
VO_KARA_04_01_Female_Human_CroneTurn3_01	¡Venga, cogeos del brazo! ¡La unión hace la fuerza!	
VO_KARA_06_01_Male_Human_JulianneDeadlyPoison_02	Ah, un frasco de veneno.	
VO_KARA_06_01_Male_Human_JulianneTurn1_01	¿Me provocáis? ¡Mi carga recibiréis, pues!	
VO_KT_ANTI_CHEESE1_65	Esta es la versión heroica de Naxxramas. No toleraré trucos baratos.	
VO_KT_ANTI_CHEESE2_66	¿Orador del Sino? Te lo tienes muy creído.	
VO_KT_ANTI_CHEESE3_67	¿Igualdad? De eso nada.	
VO_KT_ANUB2_43	¡Nooo! Quiero decir... Minucias. Nunca derrotarás a la Gran Viuda.	
VO_KT_BARON2_64	¡El Arrabal Militar me ha fallado! ¡Cómo está el servicio!	
VO_KT_FAERLINA2_45	Faerlina carecía de importancia. La reina de las arañas te despachará FÁCILMENTE.	
VO_KT_GLUTH2_73	Les pregunté a los zombis si querían devorar tus sesos y contestaron que no quieren comida basura. ¡Muajajajaaaaa!	
VO_KT_GLUTH2_ALT_74	Existe un logro por perder contra Gluth. Estoy seguro.	
VO_KT_GLUTH3_75	¡JAJAJA, NO HAY LOGRO POR PERDER CONTRA GLUTH!	
VO_KT_GLUTH4_76	¡No! ¿Y ahora quién se va a comer a todos estos zombis?	
VO_KT_GLUTH5_77	Diezmar es lo que más me gusta. No, espera, prefiero lo de congelar la sangre en tus venas.	
VO_KT_GLUTH6_78	¡Buen perro! ¡Perrito guapo!	
VO_KT_GOTHIK2_62	¿Cómo es que Gothik no vuelve como espectro? ¡Venga ya!	
VO_KT_GROBBULUS2_71	Vuelta al punto de partida...	
VO_KT_HEIGAN2_55	Estoy hirviendo de ira. HIRVIENDO.	
VO_KT_LOATHEB2_57	No dejas de MATAR A MIS ESBIRROS. ¡Para! ¡Para ahora mismo!	
VO_KT_MAEXXNA2_47	Su veneno hará que tu muerte sea "casi" indolora.	
VO_KT_MAEXXNA3_48	¿Gigante de mar? ¡Maexxna, esa carta no está en mi lista de cartas aprobadas!	
VO_KT_MAEXXNA4_49	¡Imposible! ¡Esto no ha terminado, insignificante mortal!	
VO_KT_MAEXXNA6_51	¿Cómo llamas a un esbirro atrapado en una telaraña? ¡BOCADILLO!	
VO_KT_NOTH2_53	Pobre Noth. ¡Hoy Noth da una!	
VO_KT_PATCHWERK2_69	¡Mi avatar de guerra! Debí fabricarlo con mejores jugadores...	
VO_KT_RAZUVIOUS2_59	¡¿Y ahora quién entrenará a mis caballeros de la Muerte?! Yo no puedo, estoy superocupado.	
VO_KT_SAPPHIRON2_84	Mira a ese pequeño gnomo. Era un insolente, COMO TÚ.	
VO_KT_SAPPHIRON3_85	¡Deja de esconderte tras ese bloque de hielo!	
VO_KT_SAPPHIRON4_ALT_87	Sapphiron, pon en marcha el plan "CONGELAR LA SANGRE EN TUS VENAS".	
VO_KT_SAPPHIRON5_88	¡Mi dragón! NO ME GUSTAS.	
VO_KT_THADDIUS2_81	¡Insolente! ¡Esta es la gota que colma el vaso!	
VO_LOE_01_DEATH_2	¡Orsis! ¡Véngame!	
VO_LOE_01_RESPONSE	¡Teme la cólera del Sol!	
VO_LOE_01_STAFF	¡Ja, ja! ¡Mía!	
VO_LOE_01_STAFF_2	¡Arderás!	
VO_LOE_01_STAFF_2_RENO	Intenta no perder la vara. Es valiosa, ¿sabes?	
VO_LOE_01_START	¡Soy INVENCIBLE!	
VO_LOE_01_WIN	¡Ja, ja! ¡La vara es mía! ¡Ojalá Harrison pudiera verme ahora!	
VO_LOE_01_WIN_2	¡Cógela!	
VO_LOE_01_WIN_2_ALT_2	Eh… ¿Es normal que el suelo tiemble tanto?	
VO_LOE_01_WOUNDED	¡Está contra las cuerdas! ¡Acaba con él!	
VO_LOE_02_DEATH	Otra vez a la lámpara: ¡nooooo!	
VO_LOE_02_INTRO	¡La Vara del Sol es MÍA!	
VO_LOE_02_MORE_WISHES	Vaya, no me creo que haya funcionado.	
VO_LOE_02_PHAERIX_STAFF_RECOVER	¡No comprendes los poderes de la vara!	
VO_LOE_02_RESPONSE	¡Fenomenales poderes cósmicos!	
VO_LOE_02_START	¡Libre, al fin! ¡Tu recompensa será una muerte rápida!	
VO_LOE_02_START2	¡Hola! Soy Reno Jackson: arqueólogo, expedicionario y cazatesoros famoso en el mundo entero.	
VO_LOE_02_START3	Y con el autocontrol de una urraca.	
VO_LOE_02_TURN_10	Imagina... ¡La Vara del Sol! ¡Vale una fortuna!	
VO_LOE_02_TURN_6	¿Alguna vez os he contado cuando me infiltré entre los ogros de La Masacre disfrazado?	
VO_LOE_02_TURN_6_2	¿Y cuando me colé en el Lyceum Roca Negra para hacerme con…?	
VO_LOE_02_WIN	¡Adelante! ¡La vara está en esa sala!	
VO_LOE_02_WISH	Está bien que conceda deseos mientras intenta matarnos.	
VO_LOE_03_RESPONSE	¡Date prisa!	
VO_LOE_03_TURN_1	¡El techo se derrumba y hay monstruos por doquier! ¡Aprisa!	
VO_LOE_03_TURN_10	¡Casi estamos! ¡Veo el sol!	
VO_LOE_03_TURN_2	Vaya, una poza brillante. ¿Quieres echar un vistazo?	
VO_LOE_03_TURN_2_2	¡No hay tiempo para eso!	
VO_LOE_03_TURN_3	Mmm… Vale… ¿Derecha o izquierda?	
VO_LOE_03_TURN_3_BOULDER	¡Esa roca es enorme! ¡Apártate!	
VO_LOE_03_TURN_3_WARNING	Los temblores empeoran. ¡Apuesto a que el techo se desploma en el siguiente turno!	
VO_LOE_03_TURN_4	¡Eh, una fosa de pinchos!	
VO_LOE_03_TURN_4_BAD	¡Ay, ay, ay! Eso ha tenido que doler.	
VO_LOE_03_TURN_4_GOOD	¡Bien! Casi tan hábil como yo.	
VO_LOE_03_TURN_4_NEITHER	Vale. ¿Estás pasando entre los pinchos? ¡Date prisa!	
VO_LOE_03_TURN_5	Eh, bonita estatua. Y qué rubí tan brillante…	
VO_LOE_03_TURN_5_4	Oh, oh, no parece muy contento. Creo que quiere recuperar su gema.	
VO_LOE_03_TURN_6	¡Cuidado! ¡El techo se viene abajo!	
VO_LOE_03_TURN_6_2	¡Ha faltado poco! ¡Me alegro de haber podido salvarte! De nada.	
VO_LOE_03_TURN_7	Mmm. Por aquí está bastante oscuro, pero seguro que saldremos más rápido. ¡Vamos!	
VO_LOE_03_TURN_7_2	En mi mapa pone "NO ENTRAR".	
VO_LOE_03_TURN_8	¡Uh! Se está caldeando la cosa. ¡Démonos prisa!	
VO_LOE_03_TURN_9	Puaj. ¿Por qué siempre son bichos?	
VO_LOE_03_WIN	¡Lo logramos! Nunca pensé que me alegraría de ver este desierto... desierto. Creo que necesito agua.	
VO_LOE_04_RESPONSE	¡Trogg aplastar a tonto!	
VO_LOE_04_SCARVASH_TURN_2	¡Trogg no tonto! ¡Trogg dejarte tonto!	
VO_LOE_04_START	¡Uldaman ser solo para troggs!	
VO_LOE_04_WIN	¡Aún quedan más! ¡Por aquí, héroe, salta a la vagoneta!	
VO_LOE_07_RESPONSE	¿De verdad tienes tiempo para eso?	
VO_LOE_07_START	¡Cuidado, nos persiguen!	
VO_LOE_07_WIN	¡Ja, ja! ¡En vagoneta y tirando bombas! ¡Esto es la caña!	
VO_LOE_08_ANIMATE_STONE	¡Tierra y piedra, despertad!	
VO_LOE_08_LANDSLIDE	¡Te enterraré!	
VO_LOE_08_RESPONSE	Te haré polvo.	
VO_LOE_08_START	¡Quién desafía la cólera de los creadores!	
VO_LOE_08_WIN	¡La cabeza es nuestra! ¡Solo falta una pieza!	
VO_LOE_092_Attack_02	¡Abrid bien los ojos!	
VO_LOE_10_NYAH	¡Mrrrglmrrrgl ña!	
VO_LOE_10_RESPONSE	Mrglmrrglrmrrgl.	
VO_LOE_10_RESPONSE_ALT_read	Menudo cansino estás hecho, Aletete.	
VO_LOE_10_START	Mrglmrglmrgl 	
VO_LOE_10_START_2	¿En serio? Qué falta de respeto.	
VO_LOE_10_TURN_2_GIANTFIN	¡MRRRGL! ¡MRRRGLMRGL!	
VO_LOE_10_TURN1	¡Mrrrgl! Mrrglrrglmrgl.	
VO_LOE_10_WIN	Una pena. Con una educación adecuada, podría haber sido alguien de bien.	
VO_LOE_12_NAZJAR_PEARL	Extraordinario. La Perla de las Mareas supera todas mis expectativas.	
VO_LOE_12_NAZJAR_TURN_1	Soy la hoja de Azshara. ¿Quién eres tú para desafiarme?	
VO_LOE_12_NAZJAR_TURN_1_FINLEY	Soy Sir Finley Mrrgglton. El placer es mío.	
VO_LOE_12_NAZJAR_TURN_3_FINLEY	Elise, ¿cómo les va a los demás?	
VO_LOE_12_NAZJAR_TURN_5	¡Ejércitos de las profundidades, barred a los enemigos con una marea de muerte!	
VO_LOE_12_NAZJAR_TURN_5_FINLEY	Eso suena un poco excesivo.	
VO_LOE_12_NAZJAR_TURN_7_FINLEY	¡Mrgggl! ¡MRRGLMRRGL!	
VO_LOE_12_NAZJAR_TURN_7_FINLEY_2	Lo siento, a veces me olvido hasta de quién soy.	
VO_LOE_12_RESPONSE	¡Tengo el poder de la perla!	
VO_LOE_12_START	¡El poder de las mareas te consumirá!	
VO_LOE_12_WIN	¡Bravo! ¡La perla es nuestra! ¡Acompáñame a la Sala de los Expedicionarios y ensamblaremos el artefacto juntos!	
VO_LOE_13_RESPONSE	RAAAAARR	
VO_LOE_13_START_2	¡Roar!	
VO_LOE_13_TURN_1	¡El bastón estaba maldito! Invocó al etéreo. ¡Lo está robando todo!	
VO_LOE_13_TURN_1_2	No todo. Solo lo bueno.	
VO_LOE_13_TURN_5	Oooh, ¿eso es el sello de Arthas? Y en perfecto estado.	
VO_LOE_13_TURN_5_2	¡Reno, Brann, esconded los artefactos!	
VO_LOE_13_TURN_9	¡Está dando vida a un ejército! ¡Elise, detenlo!	
VO_LOE_13_TURN_9_2	¡Tel'zaxus Nalore! ¡El bastón es demasiado fuerte, pero puedo ralentizarlo!	
VO_LOE_13_WIN	Ayudaremos con las piezas de la exposición. ¡Vamos, ve a por Rafaam!	
VO_LOE_14_RESPONSE	CLACK	
VO_LOE_14_START	¡Oh! ¡Esa es la armadura de Lothar! ¡Me pasé meses buscando entre caca de dragón en Roca Negra!	
VO_LOE_14_TURN_13	¡Brann, está dando vida a los libros! Yo me ocupo de los martillos voladores de la exposición de Lordaeron.	
VO_LOE_14_TURN_5	He despachado a las espadas animadas de la sala este. Elise, ¿a quién puedo ayudar?	
VO_LOE_14_TURN_5_2	¡Reno está en el almacén principal! ¡Varios robots bum lo tienen rodeado!	
VO_LOE_14_TURN_9	Parecéis muy ocupados. Me entretendré cogiendo este broche.	
VO_LOE_14_WIN	El museo está controlado. ¡Ve a por Rafaam!	
VO_LOE_15_RESPONSE	¡Qué cartas tan buenas!	
VO_LOE_15_SPARE	¡Mira! Tenemos un mazo de sobra: ¡úsalo!	
VO_LOE_16_BOOM_BOT	Tenemos un montón de estos de sobra. ¡Acaba con él!	
VO_LOE_16_CROWN	Las artes de un mago loco en estado puro.	
VO_LOE_16_EYE	Qué gracia, aún tenía esto en el bolsillo. Te lo presto.	
VO_LOE_16_FIRST_ITEM	Vamos a buscar artefactos útiles por el museo. ¡Avisa si necesitas alguno!	
VO_LOE_16_GOBLET	Odio las serpientes.	
VO_LOE_16_GREAVE	Una pieza de la armadura de Lothar permaneció intacta tras tu pelea.	
VO_LOE_16_LOCKET	Los fantamas de Karazhan poseen este guardapelo.	
VO_LOE_16_PIPE	¡Cógela! Pero no se lo digas a Brann; ¡le encanta esta pipa!	
VO_LOE_16_RAFAAM_DEATH2	¡NO! ¡No podéis derrotarme!	
VO_LOE_16_SHARD	Esto estaba en una caja que decía: "NO ABRIR". Así que… ¡Buena suerte!	
VO_LOE_16_SPLINTER	Encontré esto en Núcleo de Magma. El mayordomo lo usaba de mondadientes.	
VO_LOE_16_START_2	El bastón se está cargando. ¡Cuidado!	
VO_LOE_16_TEAR	Un artefacto sagrado de mi pueblo. ¡Rápido, bebe!	
VO_LOE_16_TURN_2	El bastón casi está al máximo. ¡Prepárate!	
VO_LOE_16_TURN_2_2	¡JA, JA, JA! ¡PODER ABRUMADOR!	
VO_LOE_16_TURN_2_3	¡El bastón se ha sobrecargado! ¡Es tu ocasión!	
VO_LOE_16_TURN_3	¡Soy invencible! ¡Nunca me derrotaréis!	
VO_LOE_16_TURN_3_2	El bastón vuelve a cargarse. Pronto tendremos otra oportunidad.	
VO_LOE_16_TURN_4	El bastón casi está listo. ¡Prepárate!	
VO_LOE_16_TURN_5	¡JA, JA, JA! ¡PODER ABRUMADOR!	
VO_LOE_16_TURN_5_2	¡Sus escudos han caído! ¡A por él!	
VO_LOE_16_TURN_6	Ha recuperado los escudos. ¡Cuidado!	
VO_LOE_16_VIAL	Dice "Bébeme", pero lo encontramos en Naxxramas, así que nadie ha querido probarlo.	
VO_LOE_ARCHAEDAS_TURN_1_CARTOGRAPHER	Si no estuviese demasiado ocupado sepultándote.	
VO_LOE_GIANTFIN_TIDEHUNTER_2	¡No, Finley! Ya entonces eras diferente.	
VO_LOE_NAZJAR_TURN_3_CARTOGRAPHER	Reno ha vuelto con la Vara del Sol y Brann está en camino.	
VO_LOE_SCARVASH_TURN_6_CARTOGRAPHER	¡Céntrate, Brann!	
VO_LOE_ZINAAR_TURN_10_CARTOGRAPHER_2	No vamos a venderla.	
VO_LOE_ZINAAR_TURN_6_CARTOGRAPHER_2	Sí.	
VO_LOE_ZINAAR_TURN_6_CARTOGRAPHER_2_ALT	Sí.	
VO_LOE10_DEAD_MURLOCS	Cuántos muertos. Qué desgracia.	
VO_LOE10_NYAH_FINLEY	Oh, no seas pueril.	
VO_LOE10_TIDEHUNTER	Yo me crié como un cazamareas hasta que Elise me encontró. ¿Podría haber sido este mi sino?	
VO_LOE10_TURN_2_FINLEY	¡Hermanos! ¿De verdad tenemos que luchar?	
VO_LOE10_TURN_2_FINLEY_2	Supongo que eso era de esperar.	
VO_LOEA04_BRANN_TURN_1	La última vez que lo vi, Scarvash era un trogg pequeñito. Ahora es más grande, tonto y feo.	
VO_LOEA04_BRANN_TURN_6	Fascinante. Estas runas de mitril contienen código de guardián. ¡Deben datar de la era de los titanes!	
VO_LOEA07_MINE_ALMOST_DONE	¡Casi estoy! Me pregunto qué hará este botón…	
VO_LOEA07_MINE_ARCHAEDAS	POR LAS BARBAS DE MAGNI… ¿ES ESE ARCHAEDAS?	
VO_LOEA07_MINE_BARREL_FORWARD	¡A toda máquina!	
VO_LOEA07_MINE_BOOM	¡Bombas que rebotan! ¡Así aprenderán!	
VO_LOEA07_MINE_BOOMZOOKA	¡BUM! ¡Voy a cargar otra ronda!	
VO_LOEA07_MINE_DETONATE	¿Vas a detonar la bocamina? ¿SE TE VA LA PINZA?	
VO_LOEA07_MINE_DYNAMITE	¡Eh! ¡Ten más cuidado! ¡Has arrancado un cacho de vía!	
VO_LOEA07_MINE_HUNKER_DOWN	¡Abajo!	
VO_LOEA07_MINE_PARROT	¡Vuela, Ginny!	
VO_LOEA07_MINE_RAMMING	¡Ja, ja! ¡Fuera de nuestro camino!	
VO_LOEA07_MINE_REPAIRS	¡Con un poco de resina de mollejas quedará como nuevo!	
VO_LOEA07_MINE_SPIKED_DECOY	¡Malditos troggs! ¡Venid a por mí!	
VO_LOEA08_TURN_1_BRANN	Un sirviente de los antiguos titanes. La de historias que podría contarnos.	
VO_LOEA09_1_RESPONSE	¡Más para cenar!	
VO_LOEA09_1_TURN1	¿Osas invadir la Ciudad en Ruinas?	
VO_LOEA09_FINLEY_DEATH	Me recuperaré en un instante. ¡Ajusticia al naga!	
VO_LOEA09_HERO_POWER	¡Hora de cenar! ¡Hoy hay sopa de múrloc!	
VO_LOEA09_HERO_POWER1	Saludos. Parece que tengo un contratiempo. ¿Serías tan amable de ayudarme?	
VO_LOEA09_HERO_POWER2	Debo decir que esto está terriblemente oscuro.	
VO_LOEA09_HERO_POWER3	Cáspita. ¿Está subiendo la temperatura?	
VO_LOEA09_HERO_POWER4	Debo señalar que esto es muy desagradable.	
VO_LOEA09_HERO_POWER5	Uh, me va a dar un sofoco.	
VO_LOEA09_HERO_POWER6	Agradecería mucho un poco de ayuda.	
VO_LOEA09_QUOTE1	¡Gracias! ¡Ha estado demasiado cerca!	
VO_LOEA09_UNSTABLE	¡Vuelve al caldero!	
VO_LOEA09_WIN	Tienes toda mi gratitud. ¿Vamos a por la última pieza?	
VO_LOEA10_1_MIDDLEFIN	¡¿Pero qué...?! ¿Qué haces tú aquí?	
VO_LOEA15_1_LOSS_11	Qué basura de mazo. Hora de usar el mío.	
VO_LOEA15_1_LOW_HEALTH_10	Igual me equivoqué robándote el mazo.	
VO_LOEA15_1_MAGMA_RAGER_09	¿Furibundo de magma? ¿Quién jugaría esa carta?	
VO_LOEA15_1_START_07	Me gusta tu mazo. Creo que ME LO QUEDO.	
VO_LOEA15_1_TURN1_08	Oooh, sí. Esta mano es INCREÍBLE.	
VO_LOEA15_1_WIN_12	Tu mazo es IMPRESIONANTE. ¡Ja, ja, ja!	
VO_LOEA15_GOLDEN	¿Este mazo es TODO DE CARTAS DORADAS? ¡Tu colección está al nivel de la mía!	
VO_LOEA16_1_CARD_04	¡He reunido artefactos de CIENTOS de mundos!	
VO_LOEA16_1_RESPONSE_03	¡Sí! ¡SÍ!	
VO_LOEA16_1_START_01	¡Contemplad el PODER ABSOLUTO del bastón!	
VO_LOEA16_1_TURN1_02	¡Soy invencible! ¡Blando el poder de los titanes!	
VO_Maiden_Female_Titan_FinalMaidenEmoteResponse_01	No se tolerará tu comportamiento.	
VO_Maiden_Female_Titan_FinalMaidenEyeForAnEye_01	La justicia está servida.	
VO_Maiden_Female_Titan_FinalMaidenHeroPower_01	Expulsa tus pensamientos impuros.	
VO_Maiden_Female_Titan_FinalMaidenHumility_01	¡Eso es! ¡Arrodíllate y tal vez te perdone la vida!	
VO_Maiden_Female_Titan_FinalMaidenOpen_01	¿Has llamado a una agente de los titanes?	
VO_Maiden_Female_Titan_FinalMaidenTurn5_01	¡Somos eternos, ser abyecto!	
VO_Malchezaar_Male_Demon_Brawl_06	No habrás pensado que podías vencer.	
VO_Malchezaar_Male_Demon_EmoteParty_01	¡Malchezaar también quiere marcha!	
VO_Malchezaar_Male_Demon_FinalAltOpening_01	¡Ignorantes!	
VO_Malchezaar_Male_Demon_FinalMalchezaarDeath_01	¡No! ¡No! ¡Otra vez no!	
VO_Malchezaar_Male_Demon_FinalMalchezaarEmoteResponse_01	¡Yo seré tu fin!	
VO_Malchezaar_Male_Demon_FinalMalchezaarHeroPower_01	¡No solo os enfrentáis a Malchezaar, sino a todas las legiones bajo mi mando!	
VO_Malchezaar_Male_Demon_FinalMalchezaarJaraxxus_01	¡Eh, tú! ¡Dame mi invitación!	
VO_Malchezaar_Male_Demon_FinalMalchezaarMedivhSkin_01	¿Has venido disfrazado? Mmm... Yo también podría...	
VO_Malchezaar_Male_Demon_FinalMalchezaarSacrificialPact_03	¡Ja, ja, ja! ¡Eso no funciona contra un señor eredar auténtico!	
VO_Malchezaar_Male_Demon_FinalMalchezaarTurn1_01	El magus es poderoso, pero ¿cómo esperas hacer frente a un poder tan abrumador?	
VO_Malchezaar_Male_Demon_FinalMalchezaarTurn7_01	¡Oigo la música! ¡Las Medivas! ¡Y la fiesta! ¡Hoy es mi noche!	
VO_Malchezaar_Male_Demon_FinalThirdSequence_01	¿Otra vez en Karazhan? ¡Justo a tiempo para la fiesta!	
VO_Malchezaar_Male_Demon_FinalThirdSequence_04	¡Apártate, ignorante!	
VO_Malchezaar_Male_Demon_PrologueEmoteResponse_01	¡Qué ignorante!	
VO_Malchezaar_Male_Demon_PrologueHeroPower_01	¡Tengo acceso a todas las dimensiones y realidades!	
VO_Malchezaar_Male_Demon_PrologueOpen_01	¿Dónde está mi invitación?	
VO_Malchezaar_Male_Demon_PrologueTurn1_04	¿Has olvidado invitarme? ¡Soy un príncipe de los eredar!	
VO_Malchezaar_Male_Demon_PrologueTurn11_02	¿Has invitado a Jaraxxus? ¿A ese don nadie?	
VO_Malchezaar_Male_Demon_PrologueWin_01	¡Tú te vienes conmigo!	
VO_Mediva_01_Female_Blood Elf_AranSpell_04	Oh, brrr...	
VO_Mediva_01_Female_Blood Elf_ChessEmoteOops_06	Oh-oh...	
VO_Mediva_01_Female_Blood Elf_PrologueTurn5_06	¡Medivas!	
VO_Mediva_02_Female_Draenei_JulianneDeadlyPoison_02	Trágico...	
VO_Mediva_02_Female_Draenei_PrologueTurn5_05	¿Sí?	
VO_Mediva_03_Male_Night Elf_AranHeroPower_01	¡Arde, baby, arde!	
VO_Mediva_03_Male_Night Elf_CuratorBeasts_04	Salud, baby.	
VO_Mediva_03_Male_Night Elf_PrologueTurn5_01	¿Has llamado?	
VO_Medivas_Multiple_Multiple_CroneLionTigerBear_01	¡Cielos!	
VO_Medivas_Multiple_Multiple_IllhoofWounded_01	Mmm... Tengo miedito...	
VO_Medivas_Multiple_Multiple_NetherspiteTurn1_01	¡Rayos!	
VO_Medivh_Male_Human_EmoteGreetings_01	¿Qué haces tú aquí?	
VO_Medivh_Male_Human_EmoteOops_01	¿Ese era tu plan?	
VO_Medivh_Male_Human_EmoteSorry_01	Ah, no ha funcionado...	
VO_Medivh_Male_Human_EmoteThanks_01	Eres muy amable.	
VO_Medivh_Male_Human_EmoteThreaten_01	¡No tienes ninguna posibilidad!	
VO_Medivh_Male_Human_EmoteWellPlayed_01	Buen intento, demonio.	
VO_Medivh_Male_Human_EmoteWow_01	¡Ja, ja, ja, ja, ja! ¡Increíble!	
VO_Medivh_Male_Human_FinalMalchezaarTurn5_01	Un trabajo excelente, Moroes. ¡La fiesta va como la seda!	
VO_Medivh_Male_Human_FinalMalchezaarWin_01	¡Bien hecho! ¡Vamos! ¡Vamos a la fiesta!	
VO_Medivh_Male_Human_FinalMedivhMedivhSkin_01	¡Un momento! ¿Eres mi yo del futuro? ¿Qué tal estuvo esta fiesta? Increíble, ¿a que sí?	
VO_Medivh_Male_Human_FinalThirdSequence_01	¡Una visita! Ocúpate del demonio, ¡que a mí me esperan en la fiesta!	
VO_Medivh_Male_Human_FinalThirdSequence_02	¿Te ha dejado sin cartas? Si lo deseas, usa los portales.	
VO_Medivh_Male_Human_FinalThirdSequence_03	Toma mi báculo y controla los portales, ¡pero no me lo rayes!	
VO_Medivh_Male_Human_PrologueDeath_02	¿Cómo? Imposible...	
VO_Medivh_Male_Human_PrologueHeroPower_01	¡Pero no a esta fiesta!	
VO_Medivh_Male_Human_PrologueOpen_01	Oh... ¿Otra vez tú?	
VO_Medivh_Male_Human_PrologueTurn1_02	¿Después de la última vez? ¡Aún estamos arreglando los destrozos!	
VO_Medivh_Male_Human_PrologueTurn11_01	¿Lo has oído cantar? ¡Es el amo del karaoke!	
VO_Medivh_Male_Human_PrologueTurn3_02	Moroes, ve a comprobar el ajedrez. Los invitados de verdad están al caer.	
VO_Medivh_Male_Human_PrologueTurn9_01	¡Los globos! Moroes, ¡se nos han olvidado!	
VO_Medivh_Male_Human_PrologueWin_01	¡Y no vuelvas, demonio!	
VO_Medivh_Male_Human_Wing0Intro_01	Hemos dado vida a la vajilla, ensayado la obra y preparado la Sala de las Fieras. ¡Esta noche será memorable!	
VO_Medivh_Male_Human_Wing4Win_01	¡Ven conmigo! ¡Vamos a disfrutar de la fiesta!	
VO_Mirror_Male_Mirror_MirrorDeath_01	¡Eh, has hecho trampa! ¡Quiero revancha!	
VO_Mirror_Male_Mirror_MirrorEmoteResponse_01	¡Eso tú!	
VO_Mirror_Male_Mirror_MirrorFirstCard_01	Jo, jo... ¡Menudo mazo te ha tocado!	
VO_Mirror_Male_Mirror_MirrorMedivhSkin_01	¡Oh, señor Medivh! Tan elegante como... ¡¿Qué?! ¡Un momento! ¡Tú no eres Medivh!	
VO_Mirror_Male_Mirror_MirrorMirrorImage_01	¡Eh, esa es mi carta favorita! ¿Cuál es la tuya? ¿El Furibundo de magma?	
VO_Mirror_Male_Mirror_MirrorOpen_02	¡QUÉ PASSSSAAAAA!	
VO_Mirror_Male_Mirror_MirrorTurn1_01	¡Sois tan feos que voy a llorar!	
VO_Mirror_Male_Mirror_MirrorTurn3_01	Dime, espejo glorioso: en este reino, ¿quién es el más hermoso?	
VO_Mirror_Male_Mirror_MirrorTurn3_03	¡Tú no, carcamal!	
VO_Mirror_Male_Mirror_MirrorTurn5_02	¿Nefarius? Más bien "Ne-feo-rius", ¿no? ¡Ju, ju, juu!	
VO_Mirror_Male_Mirror_MirrorWellPlayedResponse_01	¡Ojalá pudiera decirte lo mismo! ¡BAM!	
VO_Moroes_Male_Human_AranTurn1_01	Te presento a Aran, el fantasma cascarrabias.	
VO_Moroes_Male_Human_AranTurn9_04	Los dragones han engullido el bufé. ¡Ahora están mirando de reojo a los múrlocs!	
VO_Moroes_Male_Human_AranWin_01	¡El portal está en la siguiente sala! ¡Llegamos a tiempo!	
VO_Moroes_Male_Human_ChessForfeit_02	Te has quedado sin piezas, así que la partida termina aquí.	
VO_Moroes_Male_Human_ChessTurn1_03	Aquí, las piezas atacan automáticamente al final de tu turno.	
VO_Moroes_Male_Human_ChessTurn3_01	Si una pieza se encuentra entre dos enemigos, ¡atacará a los dos!	
VO_Moroes_Male_Human_ChessTurn5_01	Para ganar hay que saber posicionarse. ¡Aprovecha los ataques dobles!	
VO_Moroes_Male_Human_ChessTurn7_01	¡Los demás invitados esperan en la cola! Ya casi estamos en el teatro, ¡pero hay que darse prisa!	
VO_Moroes_Male_Human_ChessTurn7_02	Te quedan pocas piezas. Si se te acaban, perderás la partida.	
VO_Moroes_Male_Human_ChessWin_01	¡Excelente! ¡Vamos al teatro!	
VO_Moroes_Male_Human_CroneTurn5_02	El mayordomo Executus está abajo. ¿Le digo que ha venido antes de lo previsto?	
VO_Moroes_Male_Human_CroneWin_01	¡Por fin! ¡Vamos a liberar al mago!	
VO_Moroes_Male_Human_CuratorTurn3_01	¡El Curator está confuso! ¡Detenlo antes de que libere a todas las criaturas!	
VO_Moroes_Male_Human_CuratorWin_01	Muy bien, un retoque por aquí... ¡Y como nuevo!	
VO_Moroes_Male_Human_EndWing1_01	¡Maravilloso! ¡El teatro se encuentra ahí arriba! ¡Seguro que Barnes nos deja pasar un momento!	
VO_Moroes_Male_Human_FinalAltTurn5_01	Vaya... Cuántos portales... ¿Me pregunto qué habrá en este?	
VO_Moroes_Male_Human_FinalMaidenTurn1_01	Lo siento. Si te ocupas de ella, encontraré los controles adecuados.	
VO_Moroes_Male_Human_FinalMaidenTurn7_03	Ah, el mundo de los tentáculos. No es lo que buscamos.	
VO_Moroes_Male_Human_FinalNazraTurn7_02	¡Ocúpate de la orco para que podamos abrir otro portal!	
VO_Moroes_Male_Human_FinalSecondSequence_01	¡Excelente! Ahora, veamos si funciona...	
VO_Moroes_Male_Human_FInalStartSequence_01	Mmm... A ver... Tal vez... ¿este?	
VO_Moroes_Male_Human_FinalThirdSequence_01	¡Es este!	
VO_Moroes_Male_Human_FinalTurn1_02	¡Ups! Ese no era. Tú lucha y yo sigo buscando.	
VO_Moroes_Male_Human_IllhoofKilrekResponse_01	¿Qué están intentando invocar?	
VO_Moroes_Male_Human_JulianneTurn5_01	¡Barnes, déjanos pasar! ¡Hay que encontrar a Medivh antes de que la fiesta sea un fiasco!	
VO_Moroes_Male_Human_JulianneTurn9_02	¡Ha llegado Illidan! ¡No estamos preparados!	
VO_Moroes_Male_Human_MedivhSkinResponse_01	¿Un disfraz de Medivh? ¡Vaya, el parecido es asombroso!	
VO_Moroes_Male_Human_MirrorTurn3_01	Mmmm...	
VO_Moroes_Male_Human_MirrorTurn5_01	Lord Nefarius llegará pronto. Tiemblo solo de pensar en cómo reaccionará...	
VO_Moroes_Male_Human_MirrorWin_02	¡Magnífico! ¡Las escaleras del teatro están muy cerca!	
VO_Moroes_Male_Human_NetherspiteTurn1_01	Esos haces potencian al dragón. ¡Usa esbirros para bloquearlos!	
VO_Moroes_Male_Human_NetherspiteTurn5_01	¡Dinos dónde está Medivh!	
VO_Moroes_Male_Human_NetherspiteTurn7_01	¡Los necesitamos! ¡Los invitados están lanzando libros a la piscina de maná!	
VO_Moroes_Male_Human_NetherspiteWin_01	¡Genial! Ahora, a ver si recuerdo cómo funciona esto...	
VO_Moroes_Male_Human_NightbaneTurn3_01	Curator, ¡debemos rescatar a Medivh!	
VO_Moroes_Male_Human_NightbaneTurn7_01	La Liga de Expedicionarios ha llegado. ¡RENO, NO TOQUES LA VAJILLA!	
VO_Moroes_Male_Human_PrologueTurn11_01	Ejem... Y no incendió la biblioteca...	
VO_Moroes_Male_Human_PrologueTurn5_03	Señor, las Medivas están listas. Barnes está supervisando sus ensayos.	
VO_Moroes_Male_Human_PrologueTurn7_01	Yo echaría un vistazo fuera, señor. Hay jefes de banda matándose por una invitación.	
VO_Moroes_Male_Human_PrologueTurn9_02	Señor, horrorizan a los múrlocs. Aún recuerdo la semana pasada...	
VO_Moroes_Male_Human_PrologueWin_02	Esto no me gusta. No me gusta nada.	
VO_Moroes_Male_Human_SilverwareResponse_01	Oh, ese era una reliquia.	
VO_Moroes_Male_Human_SilverwareTurn3_02	¡La vajilla se ha unido contra nosotros! ¡Nos ha acorralado!	
VO_Moroes_Male_Human_SilverwareWin_01	Ay, menudo desastre.	
VO_Moroes_Male_Human_Wing1Intro_02	Soy Moroes, el administrador de Karazhan. Te necesito, ¡Medivh ha desaparecido! ¡Los portales de lo alto de la torre servirán para salvarlo a él y a la fiesta!	
VO_Moroes_Male_Human_Wing1Win_01	¡Buen trabajo! ¡A este paso, llegaremos arriba a tiempo para salvar la fiesta!	
VO_Moroes_Male_Human_Wing2Win_01	¡Adelante! Arriba, el Curator custodia la Sala de las Fieras. Espero que no se haya averiado...	
VO_Moroes_Male_Human_Wing3Open_02	El Curator custodia la Sala de las Fieras, donde verás las criaturas más exóticas de Azeroth. ¡Más allá se encuentran los aposentos del amo y el portal para salvarlo!	
VO_Moroes_Male_Human_Wing3Win_02	¡Ya falta poco! ¡Salvemos a Medivh antes de que la fiesta se convierta en un campo de batalla!	
VO_Moroes_Male_Human_Wing4Intro_01	¡Por fin! ¡Ya hemos llegado! ¡Busca el portal apropiado y rescata a Medivh!	
VO_Moroes_Male_Human_Wing4Win_01	No me creo que la fiesta haya empezado a tiempo. ¿Haces algo la semana que viene? Es el cumpleaños de Medivh y me iría bien una ayuda.	
VO_Moroes_Male_Human_WolfClaws_03	Mmm... No sé yo...	
VO_NAX1_01_CARD_02	Solo un bocado...	
VO_NAX1_01_DEATH_05	¿Por qué? ¡Oh! ¿Por qué?	
VO_NAX1_01_EMOTE_04	¡Pero si habla!	
VO_NAX1_01_HP_03	Qué bocado tan sabroso.	
VO_NAX1_01_START_01	Te doy la bienvenida a mi sala.	
VO_NAX10_01_DEATH_LINE_03	¿Qué pasó con Remendejo?	
VO_NAX10_01_EMOTE1_04	¿Hora de jugar?	
VO_NAX10_01_EMOTE2_05	¡Sí! ¡Jugar! ¡Jugar!	
VO_NAX10_01_HP_02	¿Se acabó el juego?	
VO_NAX10_01_START_01	¡Remendejo quiere jugar!	
VO_NAX11_01_CARD_03	Moco.	
VO_NAX11_01_DEATH_05	*ugh uh ahoh gowr grrrlrrlrrlaaahhh*	
VO_NAX11_01_EMOTE_04	No hablar.	
VO_NAX11_01_HP_02	Peste.	
VO_NAX11_01_START_01	Carne.	
VO_NAX12_01_CARD_01	*Rugido*	
VO_NAX12_01_DEATH_01	*Gemido*	
VO_NAX12_01_EMOTE_01	*Gruñido*	
VO_NAX12_01_EMOTE_02	*Grrr*	
VO_NAX12_01_EMOTE_03	*Grrroooooo*	
VO_NAX12_01_HP_01	*Roooar CHOMP*	
VO_NAX12_01_START_01	*Gruñido*	
VO_NAX13_01_DEATH_LINE_03	Gracias...	
VO_NAX13_01_EMOTE_04	¡Matar!	
VO_NAX13_01_HP_02	¡Muere ahora!	
VO_NAX13_01_START_01	Debo... obedecer...	
VO_NAX14_01_CARD_01	*RrrrrAAAHH*	
VO_NAX14_01_DEATH_01	*Raaaaar*	
VO_NAX14_01_EMOTE_01	*Rrrr ¡Rrahhh!*	
VO_NAX14_01_EMOTE_02	*Grraaaaah*	
VO_NAX14_01_EMOTE_03	*Raaaaar*	
VO_NAX14_01_HP_01	*Raaarrr*	
VO_NAX14_01_START_01	*RAAAARRR*	
VO_NAX15_01_BIGGLES_32	¡No! ¡Yo te maldigo, insolente!	
VO_NAX15_01_DEATH_LINE_08	¡Este no es el fin! Aún queda el modo heroico...	
VO_NAX15_01_DEATH_LINE2_09	¡Noooooooooooooooooooooo!	
VO_NAX15_01_EMOTE_HELLO_26	¿Siempre saludas a los que quieren matarte?	
VO_NAX15_01_EMOTE_OOPS_29	Vaya.	
VO_NAX15_01_EMOTE_SORRY_28	No importa, todos cometemos errores.	
VO_NAX15_01_EMOTE_THANKS_27	De... ¿nada?	
VO_NAX15_01_EMOTE_THREATEN_30	¡Oh, me muero de miedo!	
VO_NAX15_01_EMOTE_WP_25	Claro que he jugado bien. ¡Soy el maldito Kel'Thuzad!	
VO_NAX15_01_HP_07	¡Congelaré la sangre que corre por tus venas!	
VO_NAX15_01_HP2_05	Ahora tu alma está ligada a mí.	
VO_NAX15_01_HP3_06	No habrá escapatoria.	
VO_NAX15_01_HURRY_31	Mi paciencia tiene un límite.	
VO_NAX15_01_PHASE2_10	¡Ignorante! ¡Has debilitado tus poderes! 	
VO_NAX15_01_PHASE2_ALT_11	¡No! Se acabó tu turno. Ahora es MI turno.	
VO_NAX15_01_RESPOND_ANDUIN_24	¡Qué ingenuo! ¿Acaso no recuerdas lo que le ocurrió a Uther?	
VO_NAX15_01_RESPOND_GARROSH_15	¿Ah, sí? Muerte, entonces.	
VO_NAX15_01_RESPOND_GARROSH_ALT_16	¿Es una pregunta trampa? ¡Solo hay muerte para ti!	
VO_NAX15_01_RESPOND_GULDAN_22	Bueno, las almas tienen que ser de alguien.	
VO_NAX15_01_RESPOND_JAINA_23	De eso nada. ¡Tú irrumpiste en mi ciudad flotante!	
VO_NAX15_01_RESPOND_MALFURION_ALT_21	¿Los bosques? ¿Y qué estás haciendo en Naxxramas?	
VO_NAX15_01_RESPOND_REXXAR_19	Pues empieza a correr.	
VO_NAX15_01_RESPOND_THRALL_17	¿Luchas por un martillo? Pues vale.	
VO_NAX15_01_RESPOND_UTHER_14	Y yo lucharé con esbirros enormes y hechizos devastadores. ¡Buena suerte!	
VO_NAX15_01_RESPOND_VALEERA_18	Así. Lo. Haré.	
VO_NAX15_01_START_13	Por fin nos encontramos.	
VO_NAX15_01_SUMMON_ADDS_12	¡Os devuelvo la libertad, esbirros!	
VO_NAX2_01_CARD_02	¡Matadlos en el nombre del maestro!	
VO_NAX2_01_CUSTOM_03	¡Has fallado!	
VO_NAX2_01_DEATH_LINE_05	¡El maestro me vengará!	
VO_NAX2_01_EMOTE_06	¡Ja, ja, ja!	
VO_NAX2_01_HP_04	¡Arrodíllate ante mí, sabandija!	
VO_NAX2_01_START_01	¡Mis acólitos me sirven sin hacer preguntas!	
VO_NAX3_01_CARD_01	*Grghhghgh*	
VO_NAX3_01_DEATH_01	*Hssss*	
VO_NAX3_01_EMOTE_01	*Hssss*	
VO_NAX3_01_EMOTE_02	*Hssss*	
VO_NAX3_01_EMOTE_03	*Hssss*	
VO_NAX3_01_EMOTE_04	*Hssss*	
VO_NAX3_01_EMOTE_05	*Hssss*	
VO_NAX3_01_HP_01	*Hssss*	
VO_NAX3_01_START_01	*Correteo*	
VO_NAX4_01_CARD_03	¡No respirarás más!	
VO_NAX4_01_DEATH_LINE_04	¡Serviré a mi maestro... en la muerte!	
VO_NAX4_01_EMOTE_06	¡Muere, intruso!	
VO_NAX4_01_HP_02	¡Levantaos, soldados míos! ¡Levantaos y luchad una vez más!	
VO_NAX4_01_START_01	Otra alma para la "colección".	
VO_NAX5_01_CARD_03	¡Te abriré la MENTE!	
VO_NAX5_01_DEATH_LINE_04	Tendría que haberme duchado...	
VO_NAX5_01_EMOTE_05	No tengo tiempo para tonterías.	
VO_NAX5_01_HP_02	¡Bailad, marionetas!	
VO_NAX5_01_START_01	¿Crees que aquí estás a salvo?	
VO_NAX6_01_CARD_03	El fin está cerca.	
VO_NAX6_01_DEATH_LINE_04	*Rruuuhhhh*	
VO_NAX6_01_EMOTE_05	Malgastas tu aliento.	
VO_NAX6_01_HP_02	Ahora me perteneces.	
VO_NAX6_01_START_01	Te veo.	
VO_NAX7_01_CARD_03	Deberías haberte quedado en casa.	
VO_NAX7_01_DEATH_LINE_04	Una muerte con honor...	
VO_NAX7_01_EMOTE_05	¡Ja! ¡Aún estoy calentando!	
VO_NAX7_01_HP_02	¡Yiiaaa!	
VO_NAX7_01_START_01	No... ¡No! ¡Mis estudiantes! ¡Devuélvemelos!	
VO_NAX8_01_CARD_02	Puedes matar a mis esbirros… pero sus almas te harán una visita.	
VO_NAX8_01_CUSTOM_03	¡Jajaja! ¡Pobre infeliz! ¡Soy el Cosechador de almas!	
VO_NAX8_01_CUSTOM2_04	¡Los muertos regresan!	
VO_NAX8_01_DEATH_LINE_05	Es... mi... fin...	
VO_NAX8_01_EMOTE1_06	Tu estupidez te ha llevado hasta la muerte.	
VO_NAX8_01_EMOTE2_07	Has hecho caso omiso de poderes más allá de tu entendimiento.	
VO_NAX8_01_EMOTE3_08	Has intentado invadir el reino del Cosechador con todas tus fuerzas.	
VO_NAX8_01_EMOTE4_09	Ahora solo te queda una salida...	
VO_NAX8_01_EMOTE5_10	Ir al menú de opciones y darle a "Rendirse".	
VO_NAX8_01_START_01	Mis esbirros nunca mueren de verdad.	
VO_NAX9_01_CUSTOM_02	Basta de palabrería. ¡Que vengan!	
VO_NAX9_01_DEATH_LINE_03	¡No! ¡Necesito más tiempo!	
VO_NAX9_01_EMOTE_04	¿Quieres morir?	
VO_NAX9_01_START_01	Haremos polvo tus huesos.	
VO_NAX9_02_CUSTOM_01	¡Invasor! ¡Huye, ahora que aún puedes!	
VO_NAX9_03_CUSTOM_01	Vamos, Zeliek. Nos divertiremos un rato.	
VO_NAX9_04_CUSTOM_01	¡Venga, miserable llorica!	
VO_Nazra_Female_Orc_FinalNazraChogall_02	¿Qué hace aquí el Martillo Crepuscular? 	
VO_Nazra_Female_Orc_FinalNazraDeath_01	Por la Horda...	
VO_Nazra_Female_Orc_FinalNazraEmoteResponse_01	¡Nazra te aplastará!	
VO_Nazra_Female_Orc_FinalNazraGrom_01	¡¿Grommash?! ¡Cuánto tiempo!	
VO_Nazra_Female_Orc_FinalNazraHeroPower_01	¡Nazra gobernará este insignificante mundo!	
VO_Nazra_Female_Orc_FInalStartSequence_01	¡Tiembla ante la Horda!	
VO_NEFARIAN_ATRAMEDES_DEATH_76	Has matado a un dragón ciego. ¡Qué vergüenza!	
VO_NEFARIAN_BARON_GEDDON_DEAD_40	Estamos cerca. Sí. ¡Sí!	
VO_NEFARIAN_CHROMAGGUS_DEAD_63	En realidad Chromaggus era mi esbirro más débil. ¿Te sentías indestructible?	
VO_NEFARIAN_CHROMAGGUS1_59	¡Le puse dos cabezas porque pensé que así podría morder el doble!	
VO_NEFARIAN_CHROMAGGUS2_60	¡Infundí en él los poderes de todos los Vuelos! Es perfecto.	
VO_NEFARIAN_CHROMAGGUS3_61	Buen trabajo, Chromaggus. Buen chico.	
VO_NEFARIAN_CHROMAGGUS4_62	¿Se empieza a llenar la mano? ¡Ja, ja, ja, ja! ¡Buen perro!	
VO_NEFARIAN_COREN_DEAD_28	El Tragapenas, vaya nombre.	
VO_NEFARIAN_DRAKKISATH_DEAD_50	Estoy empezando a cabrearme.	
VO_NEFARIAN_DRAKKISATH_RESPOND_48	Sí, Drakkisath. Mortal, ¡sigues en el lado equivocado de la montaña!	
VO_NEFARIAN_DRAKKISATH1_49	Ve a jugar en el modo con rango. Esta aventura no está hecha para ti.	
VO_NEFARIAN_GARR_DEAD1_38	Deberías llevarte un trozo de Garr y lanzarlo al charco de lava de Ragnaros. Eso lo haría feliz.	
VO_NEFARIAN_GARR2_35	Ten cuidado con esas cosas rocosas, ¿quieres?	
VO_NEFARIAN_GARR3_36	Procura no explotar. Aún tienes que deshacerte de un señor elemental.	
VO_NEFARIAN_GARR4_37	Me gusta ver cómo trabajas, ¿sabes?	
VO_NEFARIAN_GRIMSTONE_DEAD1_30	¡Sigue así y pronto expulsaremos a Ragnaros de esta montaña!	
VO_NEFARIAN_HEROIC_BLOCK_77	No en modo heroico.	
VO_NEFARIAN_MALORIAK_DEATH_PT1_72	¡Felicidades! ¡Menudo logro más increíble!	
VO_NEFARIAN_MALORIAK_DEATH_PT2_73	Creo que te buscaré un nuevo nombre para conmemorar este momento.	
VO_NEFARIAN_MALORIAK_DEATH_PT3_74	"Asesino de esbirros decepcionantes, incompetentes y estúpidos". Sí, suena bien.	
VO_NEFARIAN_MALORIAK_TURN2_71	Maloriak, intenta no perder, ¿está claro?	
VO_NEFARIAN_NEF_MISSION_66	¡Eso es trampa! ¡No lo toleraré!	
VO_NEFARIAN_NEF2_65	¡No! ¡No! ¡Te destruiré!	
VO_NEFARIAN_OMNOTRON_DEAD_69	Me has ahorrado importantes costes de reparación. Gracias.	
VO_NEFARIAN_OMOKK_DEAD_46	¡Esto no tiene sentido!	
VO_NEFARIAN_OMOKK1_44	¿Qué haces aquí? Ragnaros ha muerto. Deberías estar celebrándolo con tus amigos.	
VO_NEFARIAN_OMOKK2_45	Estoy confuso. Ragnaros ya está muerto. Tu misión ha terminado. Vete a casa.	
VO_NEFARIAN_RAZORGORE_DEAD_55	¡Esos huevos estaban destinados a grandes experimentos!	
VO_NEFARIAN_REND_DEAD_53	Te estás metiendo con el dragón equivocado, mortal.	
VO_NEFARIAN_REND1_52	¡Hasta este orco sabe que lo estás haciendo mal!	
VO_NEFARIAN_THAURISSAN_DEAD_32	¡Deberías haber acabado con el otro enano! ¡Mátalos a todos!	
VO_NEFARIAN_THAURISSAN_DEAD2_33	¿Has conseguido acabar con ambos enanos? Impresionante.	
VO_NEFARIAN_VAEL_DEAD_57	¡Ja! ¡Has matado a uno de los buenos! ¿¿Te vas a poner a llorar??	
VO_Netherspite_Male_Dragon_NetherspiteAngryChicken_01	¡¿Otra vez tú?! ¡¿Por qué siempre te metes en mis portales?!	
VO_Netherspite_Male_Dragon_NetherspiteDeath_01	Mi trabajo...	
VO_Netherspite_Male_Dragon_NetherspiteEmoteResponse_01	¿Osas retar a un dragón en su laboratorio?	
VO_Netherspite_Male_Dragon_NetherspiteEmpowerment_01	¡Hay tantos mundos!... ¡Y tanto que aprender!	
VO_Netherspite_Male_Dragon_NetherspiteOpen_01	¿Quién se atreve a molestarme?	
VO_Netherspite_Male_Dragon_NetherspiteShadowBreath_01	¡Fuera!	
VO_Netherspite_Male_Dragon_NetherspiteTurn12_01	Mmm... Si 12 múrlocs salen del portal rojo a las cuatro y C'Thun llega a las cinco... Mmm... Debo tener en cuenta...	
VO_Netherspite_Male_Dragon_NetherspiteTurn3_02	¡Dejad en paz mis experimentos!	
VO_Netherspite_Male_Dragon_NetherspiteTurn5_01	¡Los portales no se tocan! ¡Están modulados a la perfección!	
VO_Netherspite_Male_Dragon_NetherspiteTurn7_01	Esa fiesta parece divertida. ¿Por qué no vas y dejas mis portales en paz?	
VO_Netherspite_Male_Dragon_NetherspiteUnstablePortal_01	Interesante... Las fluctuaciones resonantes revelan inestabilidades.	
VO_Netherspite_Male_Dragon_NetherspiteUnstablePortal_02	Qué interesante... Detecto inestabilidades.	
VO_Nightbane_Roar	*RUGIDO*	
VO_RAGNAROS_GRIMSTONE_DEAD2_66	¡YO SÍ QUE TE EXPULSARÉ A TI, LAGARTIJA!	
VO_RAGNAROS_NEF1_71	PARECE QUE NECESITAS UN POCO DE AYUDA.	
VO_RAGNAROS_NEF3_72	¡LA VENGANZA SERÁ MÍA! ¡QUE EL FUEGO TE PURIFIQUE!	
VO_RAGNAROS_NEF4_73	ENVIARÉ A MIS ESBIRROS PARA QUE TE DESTRUYAN, ALANEGRA.	
VO_RAGNAROS_NEF5_74	¡HACED CENIZAS A ESE DRAGÓN PRESUNTUOSO!	
VO_RAGNAROS_NEF6_75	¡UN REGALO DE LAS TIERRAS DE FUEGO!	
VO_RAGNAROS_NEF7_76	¡NO PUEDES APAGAR LAS LLAMAS DEL SEÑOR DEL FUEGO!	
VO_RAGNAROS_NEF8_77	¡TENDRÉ MI VENGANZA, DRAGÓN!	
VO_SilverwareGolem_Male_SilverwareGolem_SilverwareDeath_02	Pagarás los platos rotos...	
VO_SilverwareGolem_Male_SilverwareGolem_SilverwareEmoteResponse_01	¡A fregar!	
VO_SilverwareGolem_Male_SilverwareGolem_SilverwareForkedLightning_01	¿Te gustan los tenedores? ¡Porque tengo tenedores!	
VO_SilverwareGolem_Male_SilverwareGolem_SilverwareHeroPower_01	¡A poner la mesa!	
VO_SilverwareGolem_Male_SilverwareGolem_SilverwareKnifeJuggler_01	¡Oh, juego de cuchillos!	
VO_SilverwareGolem_Male_SilverwareGolem_SilverwareOpen_01	¡Me gusta bailar!	
VO_SilverwareGolem_Male_SilverwareGolem_SilverwarePlateTossing_01	¡Plato para ti! ¡Plato para mí! ¡Plato para todos!	
VO_TB_MEDIVA1_001	¡Arde!	
VO_TB_MEDIVA1_002	¡Cuidado!	
VO_TB_MEDIVA1_003	¡Oh, Tito!	
VO_TB_MEDIVA1_004	Salud.	
VO_TB_MEDIVA1_005	¡Bestial!	
VO_TB_MEDIVA1_006	Cuchi-cuchi.	
VO_TB_MEDIVA1_007	¡No! Veneno no.	
VO_TB_MEDIVA1_008	¡Brillante!	
VO_TB_MEDIVA1_009	¿Querías algo?	
VO_TB_MEDIVA2_001	¡Qué poder!	
VO_TB_MEDIVA2_002	Oscura.	
VO_TB_MEDIVA2_003	Uh, qué frío...	
VO_TB_MEDIVA2_004	¡Oh, no! ¡Una trampa!	
VO_TB_MEDIVA2_005	¡No, no, no puedo mirar!	
VO_TB_MEDIVA2_006	Qué... cuqui.	
VO_TB_MEDIVA2_007	Me encantan los diablillos.	
VO_TB_MEDIVA2_008	¡Cuánta luz!	
VO_TB_MEDIVA2_009	¡Achís! ¡Ajjj!	
VO_TB_MEDIVA2_010	¿Has llamado?	
VO_TB_MEDIVA3_001	¡Caliente!	
VO_TB_MEDIVA3_002	Puuuro hielo.	
VO_TB_MEDIVA3_003	¡A la oscura oscuridad!	
VO_TB_MEDIVA3_004	¡Una trampa!	
VO_TB_MEDIVA3_005	¡Y vaya bestias!	
VO_TB_MEDIVA3_006	¡Le sobran mascotas!	
VO_TB_MEDIVA3_007	Oh, no, pupita.	
VO_TB_MEDIVA3_008	Es veneno, pero huele a canela.	
VO_TB_MEDIVA3_009	¡Y, ahora, las Medivas!	
VO_TB_MEDIVA3_010	¡Sí!	
VO_TIRION_INTRO_03	¿Quién de vosotros será nombrado campeón?	
VO_WhiteKing_Male_ChessPiece_ChessDeath_01	Jaque mate...	
VO_WhiteKing_Male_ChessPiece_ChessEmoteGreetings_01	¿Te apetece una partida?	
VO_WhiteKing_Male_ChessPiece_ChessEmoteOops_01	Uy, vaya error...	
VO_WhiteKing_Male_ChessPiece_ChessEmoteSorry_01	Un suceso desafortunado.	
VO_WhiteKing_Male_ChessPiece_ChessEmoteThanks_01	Muy amable.	
VO_WhiteKing_Male_ChessPiece_ChessEmoteThinking_01	Mmm... Torre a A-3...	
VO_WhiteKing_Male_ChessPiece_ChessEmoteThinking_02	Caballo a F-6...	
VO_WhiteKing_Male_ChessPiece_ChessEmoteThinking_03	Reina a E-5... Eh... No, no, no...	
VO_WhiteKing_Male_ChessPiece_ChessEmoteThreaten_01	Mate en cuatro turnos.	
VO_WhiteKing_Male_ChessPiece_ChessEmoteWellPlayed_01	Jaque mate.	
VO_WhiteKing_Male_ChessPiece_ChessEmoteWow_01	¡Ah, excepcional!	
VO_WhiteKing_Male_ChessPiece_ChessOpen_02	¡En guardia!	
VOX_Nightbane_Start_01	¡Grrr!	
